Source IP,Source Port,Destination IP,Destinatino Port,Protocol,Num_pkts,Bytes,Stream ID,StoD Num_pkts,StoD bytes,DtoS Num_pkts,DtoS bytes,Captured Time,Duration,StoD bits/sec,DtoS bits/sec
192.168.0.38,51186,66.22.228.211,50001,UDP,15776,18012247,0,15115,17936733,661,75514,0,53.536196,2680314,11284
192.168.0.54,5353,224.0.0.251,5353,UDP,315,93246,1,315,93246,0,0,0.060194,5013.060049,148,0
fe80::10ea:5b59:7fe5:b963,5353,ff02::fb,5353,UDP,314,99721,2,314,99721,0,0,0.060195,5013.060049,159,0
192.168.0.15,5353,224.0.0.251,5353,UDP,922,277533,3,922,277533,0,0,0.162717,3204.244787,692,0
fe80::104b:82fd:b8fa:a3d6,5353,ff02::fb,5353,UDP,924,296433,4,924,296433,0,0,0.162717,3204.244788,740,0
192.168.0.38,55604,142.250.206.238,443,UDP,40,19296,5,19,9881,21,9415,0.919498,5.684425,13906,13250
192.168.0.38,49849,142.250.206.202,443,UDP,693,55391,6,342,29912,351,25479,0.995193,533.710325,448,381
192.168.0.38,56459,139.178.159.29,443,UDP,21,1681,7,12,1012,9,669,1.179689,110.834657,73,48
211.114.67.76,443,192.168.0.38,57867,UDP,112733,115657540,8,90684,112960021,22049,2697519,1.93972,2784.71479,324514,7749
192.168.0.27,5353,224.0.0.251,5353,UDP,167,17201,9,167,17201,0,0,2.312151,5008.760002,27,0
192.168.0.43,5353,224.0.0.251,5353,UDP,221,86341,10,221,86341,0,0,3.33707,3090.47914,223,0
fe80::807:ac3d:1c77:dc5a,5353,ff02::fb,5353,UDP,221,90851,11,221,90851,0,0,3.337071,3090.47914,235,0
192.168.0.38,63619,142.250.206.206,443,UDP,407,185349,12,190,93247,217,92102,5.260057,111.667322,6680,6598
192.168.0.38,52100,168.126.63.2,53,UDP,2,299,13,1,75,1,224,7.150315,0.005144,116640,348367
192.168.0.38,30213,168.126.63.2,53,UDP,2,199,14,1,75,1,124,7.150392,0.005069,118366,195699
192.168.0.38,54631,162.159.129.235,443,TCP,696,73437,0,461,44371,235,29066,7.724735,3124.202234,113,74
192.168.0.28,5353,224.0.0.251,5353,UDP,264,70814,15,264,70814,0,0,8.764802,5002.20426,113,0
fe80::804:6484:7cc3:9ef6,5353,ff02::fb,5353,UDP,264,76097,16,264,76097,0,0,8.764803,5002.20426,121,0
162.159.136.234,443,192.168.0.38,54630,TCP,72,7720,1,36,5044,36,2676,8.776147,195.943472,205,109
192.168.0.38,5353,192.168.0.28,5353,UDP,10,4094,17,8,3512,2,582,8.998883,4217.06222,6,1
192.168.0.38,34405,168.126.63.2,53,UDP,2,182,18,1,83,1,99,10.503844,0.005678,116942,139485
192.168.0.38,5694,168.126.63.2,53,UDP,4,396,19,2,157,2,239,10.503913,1056.37227,1,1
192.168.0.38,49305,142.250.207.110,443,UDP,19,6876,20,9,2462,10,4414,10.510427,0.259899,75783,135868
192.168.0.31,5353,224.0.0.251,5353,UDP,167,50105,21,167,50105,0,0,11.938202,4217.500335,95,0
fe80::188c:a884:b214:f66e,5353,ff02::fb,5353,UDP,167,53445,22,167,53445,0,0,11.938203,4217.500337,101,0
192.168.0.38,5353,192.168.0.31,5353,UDP,11,5345,23,11,5345,0,0,12.351396,2908.243721,14,0
192.168.0.38,51346,139.178.159.29,443,UDP,71,5595,24,38,3170,33,2425,12.724591,358.452235,70,54
192.168.0.38,52627,168.126.63.2,53,UDP,107,10700,25,107,10700,0,0,15.324532,3162.643458,27,0
192.168.0.38,54542,74.125.204.188,5228,TCP,146,8976,2,75,4224,71,4752,15.384378,3140.69596,10,12
192.168.0.45,5353,224.0.0.251,5353,UDP,240,66421,26,240,66421,0,0,15.625638,3133.589103,169,0
fe80::821:38f9:cb9c:e77,5353,ff02::fb,5353,UDP,240,71221,27,240,71221,0,0,15.625639,3133.589103,181,0
192.168.0.64,5353,224.0.0.251,5353,UDP,120,33494,28,120,33494,0,0,15.625641,463.209396,578,0
fe80::1c37:68bf:bd35:4e08,5353,ff02::fb,5353,UDP,116,34813,29,116,34813,0,0,15.625641,463.209397,601,0
192.168.0.40,5353,224.0.0.251,5353,UDP,341,103305,30,341,103305,0,0,15.728422,3205.06062,257,0
fe80::10df:6d24:75f7:e0fa,5353,ff02::fb,5353,UDP,341,110235,31,341,110235,0,0,15.728423,3205.06062,275,0
192.168.0.38,5353,192.168.0.40,5353,UDP,9,3799,32,8,3512,1,287,15.772177,3165.778642,8,0
192.168.0.42,5353,224.0.0.251,5353,UDP,213,61661,33,213,61661,0,0,16.240279,3019.105286,163,0
fe80::c53:5394:9cfd:8d70,5353,ff02::fb,5353,UDP,213,65921,34,213,65921,0,0,16.24028,3019.105285,174,0
192.168.0.38,58745,168.126.63.1,53,UDP,2,240,35,1,85,1,155,16.288359,0.005238,129820,236731
192.168.0.38,5353,224.0.0.251,5353,UDP,152,73936,36,152,73936,0,0,16.322328,5018.415062,117,0
fe80::102a:21ec:c118:a887,5353,ff02::fb,5353,UDP,261,139267,37,261,139267,0,0,16.322364,9151.594324,121,0
192.168.0.67,5353,224.0.0.251,5353,UDP,61,17686,38,61,17686,0,0,16.546613,472.119092,299,0
fe80::cac:23b6:2e8a:efea,5353,ff02::fb,5353,UDP,61,18906,39,61,18906,0,0,16.546613,472.119094,320,0
192.168.0.23,5353,224.0.0.251,5353,UDP,357,97551,40,357,97551,0,0,17.469276,3203.42228,243,0
fe80::1478:30f2:3d98:61ad,5353,ff02::fb,5353,UDP,356,104557,41,356,104557,0,0,17.469277,3203.422282,261,0
192.168.0.96,5353,224.0.0.251,5353,UDP,475,125220,42,475,125220,0,0,17.571353,3208.444527,312,0
fe80::14c2:d5d6:415b:a476,5353,ff02::fb,5353,UDP,475,134503,43,475,134503,0,0,17.571353,3208.444528,335,0
192.168.0.38,54751,104.21.234.84,443,TCP,11,765,3,5,306,6,459,18.108271,84.443971,28,43
192.168.0.88,5353,224.0.0.251,5353,UDP,257,94781,44,257,94781,0,0,21.258065,3160.937428,239,0
fe80::1000:158b:a565:dd3f,5353,ff02::fb,5353,UDP,258,100333,45,258,100333,0,0,21.258067,3160.937426,253,0
192.168.0.51,5353,224.0.0.251,5353,UDP,337,96890,46,337,96890,0,0,21.258068,5010.502911,154,0
fe80::cde:8077:34db:3749,5353,ff02::fb,5353,UDP,338,103960,47,338,103960,0,0,21.258069,5010.502913,165,0
192.168.0.17,5353,224.0.0.251,5353,UDP,164,63303,48,164,63303,0,0,21.360633,3088.122521,163,0
fe80::18dc:d5c2:8ea2:90e4,5353,ff02::fb,5353,UDP,164,66583,49,164,66583,0,0,21.360633,3088.122521,172,0
192.168.0.38,54768,104.18.22.52,443,TCP,15,918,4,8,456,7,462,24.392584,268.548489,13,13
192.168.0.38,54774,121.53.105.132,443,TCP,12,833,5,6,360,6,473,24.893731,134.913075,21,28
192.168.0.38,54770,121.53.218.25,443,TCP,12,817,6,5,294,7,523,24.893793,134.601007,17,31
192.168.0.38,54767,121.53.205.240,443,TCP,13,883,7,6,360,7,523,24.893796,133.259337,21,31
192.168.0.38,54765,211.231.99.68,443,TCP,13,883,8,6,360,7,523,24.893807,134.772695,21,31
192.168.0.38,54764,172.64.202.28,443,TCP,7,438,9,4,240,3,198,24.893825,78.92572,24,20
192.168.0.38,54769,23.67.53.144,443,TCP,10,660,10,5,306,5,354,25.394904,74.935382,32,37
192.168.0.38,54773,172.64.202.28,443,TCP,15,918,11,8,456,7,462,25.895141,267.181421,13,13
192.168.0.38,54759,116.120.5.210,443,TCP,8,555,12,4,252,4,303,27.272338,9.859014,204,245
192.168.0.38,5353,192.168.0.54,5353,UDP,14,15306,50,13,14995,1,311,28.286326,4197.882481,28,0
192.168.0.7,5353,224.0.0.251,5353,UDP,228,169102,51,228,169102,0,0,29.451042,3196.457745,423,0
fe80::1ce6:d6b2:d0bf:7b53,5353,ff02::fb,5353,UDP,235,180619,52,235,180619,0,0,29.451044,3196.457745,452,0
192.168.0.38,54771,110.76.142.63,443,TCP,2,108,13,1,54,1,54,29.560566,0.00609,70935,70935
192.168.0.38,54772,110.76.142.63,443,TCP,2,108,14,1,54,1,54,30.061738,0.007167,60276,60276
192.168.0.54,60360,192.168.0.38,7000,TCP,12,2613,15,6,449,6,2164,30.837985,0.074686,48094,231797
192.168.0.38,54749,146.75.49.91,443,TCP,15,1017,16,7,414,8,603,32.088291,159.691202,20,30
192.168.0.38,54962,239.255.255.250,1900,UDP,4,872,53,4,872,0,0,33.190651,3.022444,2308,0
192.168.0.38,54752,185.199.110.153,443,TCP,18,1116,17,9,498,9,618,33.630651,259.310308,15,19
192.168.0.42,59896,192.168.0.38,7000,TCP,15,4271,18,7,527,8,3744,34.568675,0.056965,74010,525796
192.168.0.38,54763,211.249.222.33,443,TCP,2,108,19,1,54,1,54,34.775467,0.006101,70808,70808
192.168.0.38,6948,168.126.63.2,53,UDP,2,198,54,1,91,1,107,37.964644,0.00553,131645,154792
192.168.0.38,39707,168.126.63.2,53,UDP,2,242,55,1,91,1,151,37.964698,0.005475,132968,220639
192.168.0.38,53401,142.250.206.202,443,UDP,19,6896,56,9,2466,10,4430,37.970686,0.264967,74454,133752
192.168.0.38,53476,17.57.145.137,443,TCP,271,75278,20,148,54360,123,20918,39.807649,4971.975885,87,33
192.168.0.38,50165,168.126.63.1,53,UDP,2,264,57,1,77,1,187,43.230708,0.005372,114668,278481
192.168.0.38,61437,168.126.63.1,53,UDP,2,215,58,1,77,1,138,43.231133,0.006263,98355,176273
192.168.0.38,62101,168.126.63.1,53,UDP,2,256,59,1,91,1,165,43.236704,0.005269,138166,250521
192.168.0.38,54140,15.164.151.105,443,TCP,45,16155,21,24,4077,21,12078,43.246595,0.168607,193443,573072
192.168.0.38,62958,168.126.63.1,53,UDP,2,253,60,1,87,1,166,43.249283,0.005313,130999,249952
192.168.0.38,63767,168.126.63.1,53,UDP,2,190,61,1,87,1,103,43.249366,0.00523,133078,157552
192.168.0.38,54141,104.91.77.72,443,TCP,29,9402,22,14,1878,15,7524,43.258511,0.406798,36932,147965
192.168.0.38,54142,15.164.151.105,443,TCP,48,15048,23,26,5157,22,9891,43.421978,0.106314,388058,744285
192.168.0.38,5353,192.168.0.15,5353,UDP,71,81338,62,69,80730,2,608,47.814238,4178.411364,154,1
192.168.0.63,5353,224.0.0.251,5353,UDP,207,76723,63,207,76723,0,0,48.190846,4963.700586,123,0
fe80::493:b41b:127a:9fc6,5353,ff02::fb,5353,UDP,207,80863,64,207,80863,0,0,48.190847,4963.700585,130,0
192.168.0.38,5353,192.168.0.63,5353,UDP,3,1736,65,1,1170,2,566,48.24942,4177.757047,2,1
192.168.0.63,50254,192.168.0.38,7000,TCP,13,2679,24,6,449,7,2230,48.561853,0.038456,93405,463906
192.168.0.38,54545,210.103.251.73,443,TCP,690,100017,25,421,44396,269,55621,52.433797,3103.317054,114,143
192.168.0.38,50492,66.22.228.211,50001,UDP,17781,20302745,66,17043,20218287,738,84458,53.514117,60.024676,2694663,11256
192.168.0.38,56454,168.126.63.2,53,UDP,2,166,67,1,75,1,91,56.93077,0.005554,108030,131076
192.168.0.38,63772,168.126.63.2,53,UDP,2,210,68,1,75,1,135,56.930913,0.005412,110864,199556
192.168.0.38,56837,142.250.207.99,443,UDP,34,8617,69,16,3152,18,5465,56.937069,7.017622,3593,6230
192.168.0.12,5353,224.0.0.251,5353,UDP,32,9751,70,32,9751,0,0,58.943212,3004.255218,25,0
fe80::1c6e:7f8d:cbb4:4197,5353,ff02::fb,5353,UDP,31,10241,71,31,10241,0,0,58.943213,3004.255218,27,0
192.168.0.38,5353,192.168.0.12,5353,UDP,11,4635,72,11,4635,0,0,59.076757,3000.173069,12,0
192.168.0.38,58667,142.250.207.110,443,UDP,19,6874,73,9,2460,10,4414,68.535341,0.274013,71821,128869
0.0.0.0,68,255.255.255.255,67,UDP,102,39900,74,102,39900,0,0,72.666526,9182.006301,34,0
192.168.0.1,67,255.255.255.255,68,UDP,55,32450,75,55,32450,0,0,72.768153,4936.051685,52,0
192.168.0.4,5353,224.0.0.251,5353,UDP,33,10418,76,33,10418,0,0,72.972252,1527.452499,54,0
fe80::1082:2b98:24ad:fba7,5353,ff02::fb,5353,UDP,33,11078,77,33,11078,0,0,72.972253,1527.452499,58,0
192.168.0.38,5353,192.168.0.4,5353,UDP,10,4196,78,10,4196,0,0,73.077628,1514.450882,22,0
192.168.0.3,5353,224.0.0.251,5353,UDP,75,25428,79,75,25428,0,0,77.171593,3103.692575,65,0
fe80::1036:1312:a62:2f13,5353,ff02::fb,5353,UDP,76,27065,80,76,27065,0,0,77.171593,3103.692577,69,0
192.168.0.38,51662,142.250.206.238,443,UDP,16265,7954286,81,7606,3919334,8659,4034952,78.078273,2734.099674,11468,11806
192.168.0.38,64189,168.126.63.2,53,UDP,2,208,82,1,79,1,129,79.768412,0.005867,107721,175899
192.168.0.38,46765,168.126.63.2,53,UDP,2,242,83,1,79,1,163,79.768554,0.005726,110373,227733
192.168.0.38,56578,172.217.25.174,443,UDP,56,29780,84,25,6168,31,23612,79.775245,31.227126,1580,6049
192.168.0.38,30561,168.126.63.2,53,UDP,2,412,85,1,74,1,338,86.284156,0.005256,112633,514459
192.168.0.38,9255,168.126.63.2,53,UDP,2,173,86,1,74,1,99,86.284214,0.005198,113889,152366
192.168.0.38,57296,142.250.207.100,443,UDP,102,61464,87,39,6163,63,55301,86.289913,0.46774,105408,945841
192.168.0.54,60374,192.168.0.38,7000,TCP,12,2613,26,6,449,6,2164,88.957682,0.039979,89847,433027
192.168.0.38,45479,168.126.63.2,53,UDP,2,195,88,1,74,1,121,90.808096,0.006255,94644,154756
192.168.0.38,56429,168.126.63.2,53,UDP,2,229,89,1,74,1,155,90.808153,0.006197,95530,200096
192.168.0.38,46751,168.126.63.2,53,UDP,2,166,90,1,75,1,91,91.009538,0.006113,98151,119090
192.168.0.38,14224,168.126.63.2,53,UDP,2,210,91,1,75,1,135,91.009605,0.006046,99239,178630
192.168.0.38,54961,168.126.63.2,53,UDP,2,414,92,1,75,1,339,91.117701,0.005365,111835,505498
192.168.0.38,23804,168.126.63.2,53,UDP,2,200,93,1,75,1,125,91.117714,0.005352,112107,186846
192.168.0.38,61271,168.126.63.2,53,UDP,2,198,94,1,91,1,107,98.926738,0.005332,136534,160540
192.168.0.38,5121,168.126.63.2,53,UDP,2,232,95,1,91,1,141,98.926794,0.005277,137957,213757
192.168.0.38,61474,142.250.76.138,443,UDP,27,8022,96,13,3100,14,4922,98.932599,6.164318,4023,6387
192.168.0.38,14877,168.126.63.2,53,UDP,2,156,97,1,70,1,86,103.671416,0.006205,90249,110878
192.168.0.38,26293,168.126.63.2,53,UDP,2,227,98,1,70,1,157,103.671462,0.006158,90938,203962
192.168.0.38,54775,20.200.245.247,443,TCP,360,227783,27,130,16026,230,211757,103.677968,179.851107,712,9419
192.168.0.38,5353,192.168.0.45,5353,UDP,13,5707,99,13,5707,0,0,103.743445,2765.517352,16,0
192.168.0.38,26789,168.126.63.1,53,UDP,2,190,100,1,87,1,103,104.686939,0.005789,120228,142338
192.168.0.38,20694,168.126.63.1,53,UDP,2,234,101,1,87,1,147,104.686996,0.005732,121423,205163
192.168.0.38,62045,142.250.76.138,443,UDP,19,7232,102,9,2774,10,4458,104.693516,0.317689,69854,112260
192.168.0.38,2571,168.126.63.2,53,UDP,2,230,103,1,83,1,147,104.69576,0.005754,115397,204379
192.168.0.38,24152,168.126.63.2,53,UDP,2,231,104,1,83,1,148,104.695963,0.00555,119639,213333
192.168.0.38,54776,185.199.110.154,443,TCP,507,516265,28,93,12533,414,503732,104.701831,188.241124,532,21407
192.168.0.38,54777,185.199.110.154,443,TCP,15,5726,29,6,901,9,4825,104.705159,0.019271,374033,2003009
192.168.0.38,54778,185.199.110.154,443,TCP,15,5726,30,6,901,9,4825,104.70541,0.01915,376396,2015665
192.168.0.38,54779,185.199.110.154,443,TCP,16,5780,31,7,955,9,4825,104.705704,0.017343,440523,2225681
192.168.0.38,54780,185.199.110.154,443,TCP,14,5672,32,5,847,9,4825,104.705908,0.018523,365815,2083895
192.168.0.38,54781,185.199.110.154,443,TCP,15,5726,33,6,901,9,4825,104.706109,0.018322,393406,2106756
192.168.0.38,57266,168.126.63.2,53,UDP,2,621,105,1,89,1,532,104.710393,0.005104,139498,833855
192.168.0.38,51669,168.126.63.2,53,UDP,2,263,106,1,89,1,174,104.710436,0.00506,140711,275098
192.168.0.38,54782,185.199.111.133,443,TCP,37,10063,34,17,2241,20,7822,104.716071,188.228745,95,332
192.168.0.38,58609,168.126.63.2,53,UDP,4,432,107,3,279,1,153,104.734684,6919.213537,0,0
192.168.0.38,9195,168.126.63.2,53,UDP,2,260,108,1,89,1,171,104.734686,0.064928,10965,21069
192.168.0.38,39052,168.126.63.2,53,UDP,2,557,109,1,89,1,468,104.735118,0.007878,90378,475247
192.168.0.38,28543,168.126.63.2,53,UDP,2,338,110,1,89,1,249,104.735155,0.007842,90793,254016
192.168.0.38,47127,168.126.63.2,53,UDP,2,230,111,1,83,1,147,104.735228,0.007768,85478,151390
192.168.0.38,38212,168.126.63.2,53,UDP,2,248,112,1,83,1,165,104.735265,0.00773,85899,170763
192.168.0.38,32176,168.126.63.2,53,UDP,2,250,113,1,93,1,157,104.747583,0.008008,92907,156843
192.168.0.38,46324,168.126.63.2,53,UDP,2,271,114,1,93,1,178,104.747602,0.007989,93128,178245
192.168.0.38,57831,168.126.63.2,53,UDP,2,294,115,1,91,1,203,104.951861,0.005393,134989,301131
192.168.0.38,12136,168.126.63.2,53,UDP,2,242,116,1,91,1,151,104.951898,0.005355,135947,225583
192.168.0.38,51232,168.126.63.2,53,UDP,2,234,117,1,85,1,149,104.969514,0.006326,107492,188428
192.168.0.38,23265,168.126.63.2,53,UDP,2,255,118,1,85,1,170,104.969582,0.006257,108678,217356
192.168.0.38,54783,185.199.110.133,443,TCP,1352,1639923,35,175,15145,1177,1624778,104.976128,187.964792,644,69152
192.168.0.38,54784,185.199.110.154,443,TCP,103,65341,36,32,4014,71,61327,105.647941,187.293085,171,2619
192.168.0.38,34332,168.126.63.2,53,UDP,2,162,119,1,73,1,89,109.627965,0.005056,115506,140822
192.168.0.38,16374,168.126.63.2,53,UDP,2,206,120,1,73,1,133,109.628054,0.004967,,
192.168.0.38,60002,142.250.206.225,443,UDP,26,9816,121,12,3229,14,6587,109.633669,0.254448,101521,207099
192.168.0.38,30539,168.126.63.2,53,UDP,2,210,122,1,73,1,137,109.79082,0.006358,91852,172381
192.168.0.38,39651,168.126.63.2,53,UDP,2,254,123,1,73,1,181,109.79096,0.006219,93905,232834
192.168.0.38,58520,168.126.63.1,53,UDP,2,241,124,1,78,1,163,110.11758,0.005927,105280,220010
192.168.0.38,59681,168.126.63.1,53,UDP,2,252,125,1,78,1,174,110.117675,0.005831,107014,238724
192.168.0.38,49962,17.248.161.70,443,UDP,30,9824,126,16,5900,14,3924,110.140501,60.191663,784,521
192.168.0.38,49347,139.178.159.29,443,UDP,24,8627,127,12,4600,12,4027,110.150824,60.1813,611,535
192.168.0.38,53258,168.126.63.1,53,UDP,2,246,128,1,86,1,160,110.394011,0.004893,,
192.168.0.38,61336,168.126.63.1,53,UDP,2,236,129,1,86,1,150,110.39413,0.004775,,
192.168.0.38,54143,17.253.75.207,443,TCP,30,9062,37,14,1777,16,7285,110.401198,31.275401,454,1863
192.168.0.38,54308,168.126.63.1,53,UDP,2,258,130,1,92,1,166,110.742866,0.006373,115487,208379
192.168.0.38,59330,168.126.63.1,53,UDP,2,248,131,1,92,1,156,110.742948,0.00629,117011,198410
192.168.0.38,54144,17.253.115.198,80,TCP,36,11007,38,17,2607,19,8400,110.752411,61.161459,340,1098
192.168.0.38,63809,66.22.228.211,50001,UDP,17757,20291455,132,17027,20207793,730,83662,113.516296,60.009736,2693935,11153
192.168.0.38,33525,168.126.63.2,53,UDP,2,208,133,1,79,1,129,115.68458,0.00619,102100,166720
192.168.0.38,52122,168.126.63.2,53,UDP,2,232,134,1,79,1,153,115.684686,0.006083,103896,201216
192.168.0.38,56435,142.250.206.206,443,UDP,21,9189,135,9,4036,12,5153,115.691518,0.325227,99278,126754
192.168.0.38,48002,168.126.63.2,53,UDP,2,182,136,1,83,1,99,116.927246,0.005833,113835,135779
192.168.0.38,7428,168.126.63.2,53,UDP,2,223,137,1,83,1,140,116.927322,0.005757,115337,194545
192.168.0.38,55078,172.217.161.238,443,UDP,19,6871,138,9,2457,10,4414,116.933787,0.253133,77650,139499
192.168.0.38,62459,172.217.161.238,443,UDP,3302,354741,139,1620,159929,1682,194812,117.155675,2669.339414,479,583
192.168.0.7,137,192.168.0.255,137,UDP,32,2944,140,32,2944,0,0,132.87893,2936.259064,8,0
192.168.0.38,137,192.168.0.255,137,UDP,16,1580,141,16,1580,0,0,132.882307,6891.06599,1,0
192.168.0.38,54432,172.217.25.174,443,UDP,757,444898,142,282,42095,475,402803,142.020893,131.968185,2551,24418
192.168.0.38,53857,142.250.76.138,443,UDP,34,8926,143,16,3243,18,5683,144.784719,25.735901,1008,1766
192.168.0.50,52244,192.168.0.38,7000,TCP,13,2679,39,6,449,7,2230,148.235843,0.099831,35980,178702
192.168.0.50,5353,224.0.0.251,5353,UDP,108,37165,144,108,37165,0,0,148.547638,4076.896696,72,0
fe80::14d9:ba51:6353:9e5e,5353,ff02::fb,5353,UDP,109,39742,145,109,39742,0,0,148.547639,4076.896695,77,0
192.168.0.38,55637,239.255.255.250,1900,UDP,4,872,146,4,872,0,0,153.199115,3.011618,2316,0
192.168.0.38,24001,168.126.63.2,53,UDP,2,258,147,1,85,1,173,154.578421,0.004866,,
192.168.0.38,61394,168.126.63.2,53,UDP,2,230,148,1,85,1,145,154.57849,0.004798,,
192.168.0.38,61852,216.239.38.180,443,UDP,21,8503,149,10,3585,11,4918,154.583857,0.299756,95677,131253
192.168.0.38,55557,142.250.206.206,443,UDP,122,33007,150,58,19563,64,13444,155.467252,129.439704,1209,830
192.168.0.38,2536,168.126.63.2,53,UDP,2,236,151,1,86,1,150,156.546445,0.006129,112253,195790
192.168.0.38,19089,168.126.63.2,53,UDP,2,257,152,1,86,1,171,156.546509,0.006065,113437,225556
192.168.0.50,52245,192.168.0.38,7000,TCP,12,2613,40,6,449,6,2164,159.32918,0.052262,68730,331254
192.168.0.38,50895,168.126.63.2,53,UDP,2,198,153,1,91,1,107,160.753539,0.005556,131029,154067
192.168.0.38,33237,168.126.63.2,53,UDP,2,242,154,1,91,1,151,160.753598,0.005498,132411,219716
192.168.0.38,64841,142.250.207.106,443,UDP,19,6891,155,9,2461,10,4430,160.759689,0.263728,74652,134380
192.168.0.38,60969,142.250.207.100,443,UDP,2240,1659831,156,622,99178,1618,1560653,164.259432,104.386618,7600,119605
192.168.0.38,3722,192.168.0.36,3722,UDP,2,92,157,2,92,0,0,167.265216,2532.820956,0,0
192.168.0.38,25663,168.126.63.2,53,UDP,2,195,158,1,74,1,121,168.635634,0.006048,97883,160052
192.168.0.38,62172,168.126.63.2,53,UDP,2,219,159,1,74,1,145,168.635694,0.005988,98864,193720
192.168.0.38,1631,168.126.63.2,53,UDP,2,166,160,1,75,1,91,168.833501,0.006007,99883,121191
192.168.0.38,16555,168.126.63.2,53,UDP,2,207,161,1,75,1,132,168.833582,0.011832,50709,89249
192.168.0.38,58582,168.126.63.2,53,UDP,2,166,162,1,75,1,91,168.833679,0.004523,,
192.168.0.38,40098,168.126.63.2,53,UDP,2,210,163,1,75,1,135,168.833739,0.00577,103986,187175
192.168.0.38,62798,142.250.207.99,443,UDP,84,13342,164,42,5568,42,7774,168.840294,70.168728,634,886
192.168.0.38,64644,142.250.206.195,443,UDP,22,11140,165,11,4643,11,6497,168.845399,27.090375,1371,1918
192.168.0.38,57314,172.217.161.238,443,UDP,20,7329,166,9,2838,11,4491,169.612638,0.231675,97999,155079
192.168.0.38,54077,168.126.63.2,53,UDP,2,221,167,1,78,1,143,169.613875,0.008046,77554,142182
192.168.0.38,14147,168.126.63.2,53,UDP,2,272,168,1,78,1,194,169.613925,0.007995,78048,194121
192.168.0.38,54785,211.231.99.250,443,TCP,63,34337,41,31,7456,32,26881,169.62228,25.805589,2311,8333
192.168.0.38,24376,168.126.63.2,53,UDP,2,247,169,1,80,1,167,170.026998,0.004364,,
192.168.0.38,55703,168.126.63.2,53,UDP,2,284,170,1,80,1,204,170.027046,0.004317,,
192.168.0.38,21095,168.126.63.2,53,UDP,2,244,171,1,74,1,170,170.027266,0.005966,99228,227958
192.168.0.38,31892,168.126.63.2,53,UDP,2,289,172,1,74,1,215,170.027299,0.005934,99764,289855
192.168.0.38,54786,121.53.202.238,443,TCP,141,131259,42,41,4524,100,126735,170.031677,122.913174,294,8248
192.168.0.38,54787,211.231.116.31,443,TCP,65,11618,43,36,4983,29,6635,170.033444,15.343529,2598,3459
192.168.0.38,46040,168.126.63.2,53,UDP,2,170,173,1,77,1,93,170.072686,0.025704,23965,28944
192.168.0.38,24262,168.126.63.2,53,UDP,2,214,174,1,77,1,137,170.072714,0.006033,102105,181667
192.168.0.38,12388,168.126.63.2,53,UDP,2,213,175,1,79,1,134,170.079193,0.004438,,
192.168.0.38,54780,168.126.63.2,53,UDP,2,264,176,1,79,1,185,170.079237,0.004394,,
192.168.0.38,54788,121.53.218.25,443,TCP,30,7760,44,16,2248,14,5512,170.084044,122.860747,146,358
192.168.0.38,28142,168.126.63.2,53,UDP,2,236,177,1,80,1,156,170.090361,0.222663,2874,5604
192.168.0.38,58501,168.126.63.2,53,UDP,2,298,178,1,80,1,218,170.090414,0.00541,118299,322365
192.168.0.38,29431,168.126.63.2,53,UDP,2,380,179,1,76,1,304,170.090952,0.007437,81753,327013
192.168.0.38,40159,168.126.63.2,53,UDP,2,255,180,1,76,1,179,170.090985,0.007404,82117,193408
192.168.0.38,61056,168.126.63.2,53,UDP,2,180,181,1,74,1,106,170.092891,0.005499,107655,154209
192.168.0.38,40935,168.126.63.2,53,UDP,2,205,182,1,74,1,131,170.092894,0.005495,107734,190718
192.168.0.38,54789,23.67.53.138,443,TCP,298,330866,45,62,5855,236,325011,170.098666,120.278575,389,21617
192.168.0.38,54790,211.231.100.117,443,TCP,128,105353,46,48,6744,80,98609,170.098775,122.844334,439,6421
192.168.0.38,50342,172.217.161.195,443,UDP,61,41169,183,24,3725,37,37444,170.099158,0.308357,96641,971445
192.168.0.38,47879,168.126.63.2,53,UDP,2,208,184,1,77,1,131,170.10947,0.218538,2818,4795
192.168.0.38,44637,168.126.63.2,53,UDP,2,259,185,1,77,1,182,170.109516,0.004997,,
192.168.0.38,14538,168.126.63.2,53,UDP,2,247,186,1,80,1,167,170.161131,0.006649,96255,200932
192.168.0.38,54791,211.249.219.23,443,TCP,47,25142,47,22,2650,25,22492,170.168143,122.774999,172,1465
192.168.0.38,47075,168.126.63.2,53,UDP,2,208,187,1,77,1,131,170.175891,0.006972,88353,150315
192.168.0.38,54792,27.0.236.25,443,TCP,143,165039,48,30,3321,113,161718,170.183351,25.244432,1052,51248
192.168.0.38,34791,168.126.63.2,53,UDP,2,292,188,1,82,1,210,170.41199,0.006548,100183,256566
192.168.0.38,61796,168.126.63.2,53,UDP,2,274,189,1,82,1,192,170.412024,0.006515,100690,235763
192.168.0.38,54793,211.249.220.83,443,TCP,37,13120,49,18,5790,19,7330,170.418873,122.524292,378,478
192.168.0.38,56612,172.217.161.238,443,UDP,19,6876,190,9,2462,10,4414,170.917984,0.267162,73723,132174
192.168.0.38,64346,66.22.228.211,50001,UDP,17785,20281803,191,17051,20197649,734,84154,173.519521,60.024461,2691922,11215
192.168.0.38,52508,168.126.63.1,53,UDP,2,288,192,1,89,1,199,177.692531,0.004388,,
192.168.0.38,61879,168.126.63.1,53,UDP,2,244,193,1,89,1,155,177.692622,0.004296,,
192.168.0.38,52074,168.126.63.1,53,UDP,2,252,194,1,96,1,156,177.697991,0.004572,,
192.168.0.38,52736,142.250.207.97,443,UDP,35,16539,195,18,5275,17,11264,177.712007,0.747787,56433,120504
192.168.0.38,65292,168.126.63.1,53,UDP,2,174,196,1,79,1,95,178.007636,0.004169,,
192.168.0.38,49267,168.126.63.1,53,UDP,4,413,197,2,150,2,263,178.020467,2045.866609,0,1
192.168.0.38,53034,168.126.63.1,53,UDP,2,196,198,1,82,1,114,178.077151,0.005144,127527,177293
192.168.0.35,5353,224.0.0.251,5353,UDP,338,95392,199,338,95392,0,0,178.245713,4857.916241,157,0
fe80::1b:8c92:e3c4:748e,5353,ff02::fb,5353,UDP,339,102283,200,339,102283,0,0,178.245714,4857.916241,168,0
192.168.0.38,55266,168.126.63.1,53,UDP,2,241,201,1,78,1,163,178.374087,0.007544,82714,172852
192.168.0.38,54601,168.126.63.1,53,UDP,2,284,202,1,78,1,206,178.374181,0.005383,115920,306148
192.168.0.38,54145,52.25.194.179,443,TCP,85,73667,50,54,65975,31,7692,178.3839,24.323343,21699,2529
192.168.0.38,58020,168.126.63.1,53,UDP,2,328,203,1,90,1,238,178.554086,0.039144,18393,48640
192.168.0.38,52639,168.126.63.1,53,UDP,2,302,204,1,90,1,212,178.554171,0.051315,14030,33050
192.168.0.38,62154,168.126.63.1,53,UDP,2,244,205,1,84,1,160,178.592893,0.009448,71126,135478
192.168.0.38,50528,168.126.63.1,53,UDP,2,296,206,1,84,1,212,178.592977,0.006586,102034,257515
192.168.0.38,65299,168.126.63.1,53,UDP,2,314,207,1,120,1,194,178.593556,0.008784,109289,176684
192.168.0.38,54146,17.248.221.10,443,TCP,88,43148,51,36,9026,52,34122,178.604961,45.778776,1577,5962
192.168.0.38,54147,54.216.252.255,443,TCP,23,15278,52,8,1434,15,13844,178.606349,24.100829,476,4595
192.168.0.38,65494,3.36.253.109,123,UDP,2,180,208,1,90,1,90,178.629255,0.018435,39056,39056
192.168.0.38,61101,193.123.243.2,123,UDP,2,180,209,1,90,1,90,178.63509,0.005779,124589,124589
192.168.0.38,57147,193.123.243.2,123,UDP,2,180,210,1,90,1,90,179.011304,0.006446,111697,111697
192.168.0.38,58715,3.36.253.109,123,UDP,2,180,211,1,90,1,90,179.22607,0.02168,33210,33210
192.168.0.38,52223,193.123.243.2,123,UDP,2,180,212,1,90,1,90,179.2497,0.006131,117435,117435
192.168.0.38,50492,3.36.253.109,123,UDP,2,180,213,1,90,1,90,179.249729,0.037177,19366,19366
192.168.0.38,61116,193.123.243.2,123,UDP,2,180,214,1,90,1,90,179.271434,0.005598,128617,128617
192.168.0.38,62266,168.126.63.1,53,UDP,2,250,215,1,95,1,155,179.285558,0.005377,141342,230611
192.168.0.38,65499,168.126.63.1,53,UDP,2,302,216,1,95,1,207,179.285652,0.005284,143830,313398
192.168.0.38,57527,3.36.253.109,123,UDP,2,180,217,1,90,1,90,179.287558,0.040318,17858,17858
192.168.0.38,49616,172.217.161.202,443,UDP,31,14982,218,16,6094,15,8888,179.293406,0.315572,154487,225317
192.168.0.38,55813,142.250.207.97,443,UDP,33,17413,219,17,5376,16,12037,179.427225,0.637726,67439,150999
192.168.0.38,58111,168.126.63.1,53,UDP,2,336,220,1,79,1,257,179.429746,0.004208,,
192.168.0.38,65305,168.126.63.1,53,UDP,4,467,221,2,164,2,303,179.429862,2149.497656,0,1
192.168.0.38,62106,168.126.63.1,53,UDP,2,361,222,1,137,1,224,179.434826,0.005011,218718,357613
192.168.0.38,54148,44.196.146.123,443,TCP,24,8860,53,10,2265,14,6595,179.44205,23.265224,778,2267
192.168.0.38,51298,142.250.207.97,443,UDP,36,17898,223,19,5710,17,12188,180.071169,0.650006,70276,150004
192.168.0.38,61541,142.250.207.97,443,UDP,34,17720,224,17,5562,17,12158,180.696416,0.64445,69044,150925
192.168.0.38,65338,142.250.207.97,443,UDP,43,29097,225,19,7627,24,21470,181.348119,0.706924,86311,242968
192.168.0.38,63422,168.126.63.1,53,UDP,2,344,226,1,75,1,269,181.359506,0.005831,102898,369061
192.168.0.38,65217,168.126.63.1,53,UDP,2,284,227,1,75,1,209,181.359623,0.005712,105042,292717
192.168.0.38,60471,168.126.63.1,53,UDP,2,288,228,1,106,1,182,181.36625,0.005457,155396,266813
192.168.0.38,54149,52.177.138.113,443,TCP,33,12294,54,16,5063,17,7231,181.374417,21.332824,1898,2711
192.168.0.38,25231,168.126.63.2,53,UDP,2,188,229,1,86,1,102,186.776559,0.006181,111308,132017
192.168.0.38,7325,168.126.63.2,53,UDP,2,232,230,1,86,1,146,186.776598,0.006143,111997,190135
192.168.0.38,61961,168.126.63.1,53,UDP,2,227,231,1,76,1,151,188.197984,0.0041,,
192.168.0.38,58486,168.126.63.1,53,UDP,2,280,232,1,76,1,204,188.19808,0.004005,,
192.168.0.38,54150,17.248.221.71,443,TCP,30,8743,55,12,2262,18,6481,188.204514,30.427881,594,1703
192.168.0.7,51826,192.168.0.38,7000,TCP,12,2612,56,6,449,6,2163,189.907917,0.04167,86201,415262
192.168.0.38,14175,168.126.63.1,53,UDP,2,190,233,1,87,1,103,190.366694,0.004723,,
192.168.0.38,14393,168.126.63.1,53,UDP,2,234,234,1,87,1,147,190.366732,0.004686,,
192.168.0.38,58198,142.250.76.138,443,UDP,18,7203,235,8,2695,10,4508,190.371952,0.150531,143226,239578
192.168.0.38,52768,168.126.63.1,53,UDP,2,342,236,1,82,1,260,194.006062,0.008192,80078,253906
192.168.0.38,51692,168.126.63.1,53,UDP,2,287,237,1,82,1,205,194.006144,0.005741,114265,285664
192.168.0.38,64183,168.126.63.1,53,UDP,2,361,238,1,137,1,224,194.014671,0.004091,,
192.168.0.38,54151,3.224.33.168,443,TCP,22,8944,57,9,2365,13,6579,194.020325,8.686951,2177,6058
192.168.0.38,64604,168.126.63.2,53,UDP,2,188,239,1,86,1,102,195.407599,0.005246,131147,155547
192.168.0.38,55319,168.126.63.2,53,UDP,2,232,240,1,86,1,146,195.407665,0.005181,132792,225439
192.168.0.38,61613,172.217.161.206,443,UDP,130,26863,241,74,9318,56,17545,195.413307,8.803709,8467,15943
192.168.0.38,55637,168.126.63.2,53,UDP,2,476,242,1,80,1,396,195.428028,0.006554,97650,483368
192.168.0.38,15091,168.126.63.2,53,UDP,2,285,243,1,80,1,205,195.428056,0.006527,98054,251263
192.168.0.38,54794,104.17.33.105,443,TCP,106,94550,58,30,4067,76,90483,195.434833,97.506263,333,7423
192.168.0.38,6627,168.126.63.2,53,UDP,2,469,244,1,76,1,393,196.787167,0.018752,32423,167662
192.168.0.38,41526,168.126.63.2,53,UDP,2,282,245,1,76,1,206,196.787252,0.022228,27352,74140
192.168.0.38,54795,13.35.125.33,443,TCP,82,49236,59,39,3960,43,45276,196.809831,96.268428,329,3762
192.168.0.47,5353,224.0.0.251,5353,UDP,167,42636,246,167,42636,0,0,197.394872,4831.495223,70,0
fe80::1005:4a67:dd2e:c718,5353,ff02::fb,5353,UDP,134,42075,247,134,42075,0,0,197.394872,3028.309022,111,0
192.168.0.38,5353,192.168.0.47,5353,UDP,40,28691,248,40,28691,0,0,197.488326,3019.687374,76,0
192.168.0.38,1994,168.126.63.2,53,UDP,2,414,249,1,75,1,339,199.136619,0.006172,97213,439403
192.168.0.38,2673,168.126.63.2,53,UDP,2,200,250,1,75,1,125,199.136654,0.006136,97783,162972
192.168.0.38,61844,142.250.76.142,443,UDP,73,33631,251,35,11479,38,22152,199.143198,15.045992,6103,11778
192.168.0.38,50814,172.217.25.174,443,UDP,27,7786,252,13,2961,14,4825,199.517498,2.065273,11469,18690
192.168.0.38,65451,168.126.63.2,53,UDP,2,416,253,1,76,1,340,200.964448,0.006217,97796,437510
192.168.0.38,7420,168.126.63.2,53,UDP,2,202,254,1,76,1,126,200.964491,0.006175,98461,163238
192.168.0.38,22916,168.126.63.2,53,UDP,2,246,255,1,75,1,171,203.666466,0.094155,6372,14529
192.168.0.38,5292,168.126.63.2,53,UDP,2,308,256,1,75,1,233,203.666498,0.172319,3481,10817
192.168.0.38,19346,168.126.63.2,53,UDP,2,246,257,1,75,1,171,203.732783,0.175847,3412,7779
192.168.0.38,51125,168.126.63.1,53,UDP,2,308,258,1,75,1,233,203.732817,0.119387,5025,15613
192.168.0.38,54829,168.126.63.2,53,UDP,2,308,259,1,75,1,233,203.753936,0.124348,4825,14990
192.168.0.38,54796,2.17.55.123,443,TCP,38,18430,60,16,2521,22,15909,203.785779,89.216842,226,1426
192.168.0.38,53167,168.126.63.2,53,UDP,2,230,260,1,75,1,155,204.351756,0.014195,42268,87354
192.168.0.38,27308,168.126.63.2,53,UDP,2,270,261,1,75,1,195,204.35179,0.014164,42360,110138
192.168.0.38,54797,104.18.12.210,443,TCP,87,74164,61,32,3689,55,70475,204.366342,88.578404,333,6364
192.168.0.38,61822,168.126.63.1,53,UDP,2,258,262,1,89,1,169,204.544505,0.005299,134364,255142
192.168.0.38,54798,162.159.133.234,443,TCP,1649,562802,62,811,57632,838,505170,204.551161,1548.613708,297,2609
192.168.0.38,5353,192.168.0.51,5353,UDP,18,20231,263,18,20231,0,0,204.700067,4821.740187,33,0
192.168.0.38,36961,168.126.63.2,53,UDP,2,182,264,1,83,1,99,210.513353,0.004702,,
192.168.0.38,61053,168.126.63.2,53,UDP,2,226,265,1,83,1,143,210.513416,0.004638,,
192.168.0.38,63803,142.250.76.142,443,UDP,27,7692,266,13,2966,14,4726,210.518516,13.941516,1701,2711
192.168.0.47,55277,192.168.0.38,7000,TCP,14,4205,63,7,527,7,3678,216.183742,0.052015,81053,565682
192.168.0.38,6318,168.126.63.2,53,UDP,2,198,267,1,91,1,107,221.570944,0.006323,115135,135378
192.168.0.38,32956,168.126.63.2,53,UDP,2,242,268,1,91,1,151,221.570997,0.00627,116108,192663
192.168.0.38,60665,142.250.76.138,443,UDP,194,62440,269,91,15000,103,47440,221.577874,62.236857,1928,6097
192.168.0.38,53501,121.53.203.203,443,TCP,71,18701,64,33,4825,38,13876,225.275918,3999.075783,9,27
192.168.0.35,49176,192.168.0.38,7000,TCP,12,2613,65,6,449,6,2164,225.484928,0.081494,44076,212432
192.168.0.50,52295,192.168.0.38,7000,TCP,12,2613,66,6,449,6,2164,225.525665,0.037471,95860,462010
192.168.0.88,57891,192.168.0.38,7000,TCP,13,2679,67,7,515,6,2164,225.730546,0.131082,31430,132070
192.168.0.42,59899,192.168.0.38,7000,TCP,14,4205,68,7,527,7,3678,225.730547,0.131081,32163,224471
192.168.0.38,63793,168.126.63.1,53,UDP,2,197,270,1,71,1,126,226.041431,0.00429,,
192.168.0.38,57236,168.126.63.1,53,UDP,2,222,271,1,71,1,151,226.041538,0.004183,,
192.168.0.38,54152,162.159.128.233,443,TCP,18,6169,69,10,1785,8,4384,226.048047,31.02724,460,1130
192.168.0.38,49857,162.159.135.232,443,UDP,22,6472,272,10,3007,12,3465,226.310784,0.054765,439258,506162
192.168.0.63,50256,192.168.0.38,7000,TCP,12,2613,70,6,449,6,2164,226.365044,0.026183,137188,661192
192.168.0.3,49538,192.168.0.38,7000,TCP,12,2612,71,6,449,6,2163,226.553467,0.044774,80225,386474
192.168.0.96,54655,192.168.0.38,7000,TCP,14,4205,72,7,527,7,3678,227.112944,0.067927,62066,433170
192.168.0.43,49201,192.168.0.38,7000,TCP,12,2613,73,6,449,6,2164,227.888432,0.061974,57959,279342
192.168.0.47,55281,192.168.0.38,7000,TCP,12,2613,74,6,449,6,2164,228.591366,0.047118,76234,367417
192.168.0.38,63272,168.126.63.1,53,UDP,2,236,273,1,78,1,158,229.767652,0.004863,,
192.168.0.38,59317,162.159.129.233,443,UDP,17,5244,274,9,2480,8,2764,229.773644,0.042419,467714,521275
192.168.0.38,34263,168.126.63.2,53,UDP,2,421,275,1,75,1,346,229.986435,0.004189,,
192.168.0.38,28138,168.126.63.2,53,UDP,2,210,276,1,75,1,135,229.986478,0.004147,,
192.168.0.38,8597,168.126.63.2,53,UDP,2,166,277,1,75,1,91,229.986659,0.00688,87209,105813
192.168.0.38,9505,168.126.63.2,53,UDP,2,207,278,1,75,1,132,229.986708,0.006831,87834,154589
192.168.0.23,51325,192.168.0.38,7000,TCP,12,2613,75,6,449,6,2164,230.284028,0.044628,80487,387917
192.168.0.38,63046,66.22.228.211,50001,UDP,17814,20373622,279,17085,20289866,729,83756,233.522385,59.938075,2708110,11179
192.168.0.38,60243,168.126.63.2,53,UDP,2,294,280,1,91,1,203,237.581729,0.005193,140188,312728
192.168.0.38,51486,168.126.63.2,53,UDP,2,242,281,1,91,1,151,237.581771,0.00515,141359,234563
192.168.0.38,33323,168.126.63.2,53,UDP,2,254,282,1,71,1,183,237.676199,0.005246,108272,279069
192.168.0.38,59961,168.126.63.2,53,UDP,2,199,283,1,71,1,128,237.676248,0.005196,109314,197074
192.168.0.38,56493,142.250.76.150,443,UDP,22,11954,284,9,2550,13,9404,237.681981,0.144736,140946,519787
192.168.0.38,9754,168.126.63.2,53,UDP,2,274,285,1,81,1,193,238.633969,0.005965,108633,258843
192.168.0.38,6905,168.126.63.2,53,UDP,2,222,286,1,81,1,141,238.634024,0.005909,109663,190895
192.168.0.38,9704,168.126.63.1,53,UDP,2,211,287,1,83,1,128,249.58045,0.005536,119942,184971
192.168.0.38,20001,168.126.63.1,53,UDP,2,245,288,1,83,1,162,249.580502,0.005485,121057,236280
192.168.0.38,44893,168.126.63.2,53,UDP,2,267,289,1,74,1,193,249.583075,0.018172,32577,84965
192.168.0.38,39783,168.126.63.2,53,UDP,2,305,290,1,74,1,231,249.583103,0.018145,32626,101846
192.168.0.38,52242,142.250.76.142,443,UDP,21,9155,291,10,4628,11,4527,249.58658,0.229458,161354,157832
192.168.0.38,54799,199.60.103.30,443,TCP,1273,1647135,76,118,13852,1155,1633283,249.601582,43.339412,2556,301486
192.168.0.38,35599,168.126.63.2,53,UDP,2,176,292,1,80,1,96,249.777675,0.005749,111323,133588
192.168.0.38,13944,168.126.63.2,53,UDP,2,220,293,1,80,1,140,249.777712,0.005712,112044,196078
192.168.0.38,34410,168.126.63.2,53,UDP,2,413,294,1,81,1,332,249.781169,0.008185,79169,324496
192.168.0.38,58333,168.126.63.2,53,UDP,2,506,295,1,81,1,425,249.781197,0.008156,79450,416871
192.168.0.38,64651,142.250.206.234,443,UDP,118,86276,296,44,5367,74,80909,249.784294,24.234797,1771,26708
192.168.0.38,48456,168.126.63.2,53,UDP,2,170,297,1,77,1,93,249.785372,0.00528,116666,140909
192.168.0.38,54537,168.126.63.2,53,UDP,2,214,298,1,77,1,137,249.785423,0.005228,117827,209640
192.168.0.38,54800,13.107.246.49,443,TCP,154,179718,77,27,2756,127,176962,249.790603,43.15248,510,32806
192.168.0.38,57336,172.217.161.195,443,UDP,1041,1092338,299,174,17904,867,1074434,249.793203,25.455585,5626,337665
192.168.0.38,50140,168.126.63.2,53,UDP,2,228,300,1,74,1,154,249.845785,0.005697,103914,216254
192.168.0.38,12825,168.126.63.2,53,UDP,2,610,301,1,74,1,536,249.845819,0.005661,104575,757463
192.168.0.38,54801,104.17.182.73,443,TCP,145,173857,78,26,2846,119,171011,249.851704,43.101889,528,31740
192.168.0.38,63717,168.126.63.2,53,UDP,2,234,302,1,77,1,157,250.071876,0.008269,74495,151892
192.168.0.38,64356,168.126.63.2,53,UDP,2,613,303,1,77,1,536,250.071916,0.008228,74866,521147
192.168.0.38,54802,104.16.85.5,443,TCP,26,9175,79,13,2143,13,7032,250.080992,42.860055,399,1312
192.168.0.38,25156,168.126.63.2,53,UDP,2,211,304,1,80,1,131,250.132875,0.005514,116068,190061
192.168.0.38,25861,168.126.63.2,53,UDP,2,264,305,1,80,1,184,250.132977,0.005413,118233,271937
192.168.0.38,1092,168.126.63.2,53,UDP,2,556,306,1,80,1,476,250.133208,0.006455,99147,589930
192.168.0.38,32498,168.126.63.2,53,UDP,2,397,307,1,80,1,317,250.133347,0.006317,101313,401456
192.168.0.38,21652,168.126.63.2,53,UDP,2,182,308,1,75,1,107,250.133678,0.005986,100233,143000
192.168.0.38,52707,168.126.63.2,53,UDP,2,229,309,1,75,1,154,250.133733,0.007069,84877,174282
192.168.0.38,54803,157.240.215.14,443,TCP,26,7956,80,13,2005,13,5951,250.139019,42.804003,374,1112
192.168.0.38,54804,192.229.237.25,443,TCP,132,152348,81,24,4363,108,147985,250.140074,42.83693,814,27636
192.168.0.38,54805,104.19.154.83,443,TCP,21,5812,82,12,1979,9,3833,250.140981,42.802014,369,716
192.168.0.38,65494,157.240.215.14,443,UDP,124,101937,310,42,4962,82,96975,250.171833,0.050773,781832,15279774
192.168.0.38,53626,168.126.63.2,53,UDP,2,230,311,1,83,1,147,250.432251,0.006319,105079,186105
192.168.0.38,48990,168.126.63.2,53,UDP,2,241,312,1,83,1,158,250.432306,0.006263,106019,201820
192.168.0.38,54806,104.244.42.136,443,TCP,26,7850,83,13,2132,13,5718,250.438858,42.575989,400,1074
192.168.0.38,52061,168.126.63.1,53,UDP,2,286,313,1,79,1,207,253.298418,0.010808,58475,153219
192.168.0.38,53740,168.126.63.1,53,UDP,2,265,314,1,79,1,186,253.298512,0.010715,58982,138870
192.168.0.38,63906,168.126.63.1,53,UDP,2,263,315,1,89,1,174,253.31015,0.0054,131851,257777
192.168.0.38,54153,54.230.61.30,443,TCP,25,9126,84,11,1548,14,7578,253.317981,1.659095,7464,36540
192.168.0.38,50911,168.126.63.1,53,UDP,2,256,316,1,86,1,170,253.775174,0.00601,114475,226289
192.168.0.38,50305,168.126.63.1,53,UDP,2,300,317,1,86,1,214,253.775287,0.005896,116689,290366
192.168.0.38,54154,52.218.181.136,443,TCP,71,67040,85,15,1831,56,65209,253.783271,1.193803,12270,436983
192.168.0.38,59148,168.126.63.1,53,UDP,2,251,318,1,86,1,165,254.712732,0.005094,135060,259128
192.168.0.38,58893,168.126.63.1,53,UDP,2,204,319,1,86,1,118,254.712808,0.005017,137133,188160
192.168.0.38,53070,104.18.4.179,443,UDP,44,19625,320,9,4559,35,15066,254.72232,180.158527,202,669
192.168.0.38,63547,168.126.63.1,53,UDP,2,234,321,1,82,1,152,255.461495,0.00925,70918,131459
192.168.0.38,52318,168.126.63.1,53,UDP,2,196,322,1,82,1,114,255.461564,0.006093,107664,149679
192.168.0.38,54155,104.18.30.100,443,TCP,19,6079,86,9,1471,10,4608,255.469788,0.279774,42062,131763
192.168.0.38,48902,168.126.63.1,53,UDP,2,190,323,1,87,1,103,262.150795,0.005043,138013,163394
192.168.0.38,30337,168.126.63.1,53,UDP,2,234,324,1,87,1,147,262.150881,0.004958,,
192.168.0.38,56028,142.250.206.234,443,UDP,18,7206,325,8,2698,10,4508,262.156569,0.137825,156604,261665
192.168.0.38,56120,168.126.63.1,53,UDP,2,298,326,1,96,1,202,266.179339,0.005049,152109,320063
192.168.0.38,59911,168.126.63.1,53,UDP,2,256,327,1,96,1,160,266.179551,0.004838,,
192.168.0.38,65061,168.126.63.1,53,UDP,2,230,328,1,78,1,152,266.188335,0.005209,119792,233442
192.168.0.38,54156,17.253.115.202,443,TCP,37,11381,87,19,3281,18,8100,266.196397,3.348611,7838,19351
192.168.0.38,54157,17.253.115.202,443,TCP,24,7682,88,11,1307,13,6375,266.53732,11.005466,950,4634
192.168.0.38,62823,168.126.63.1,53,UDP,2,178,329,1,81,1,97,268.448611,0.004993,,
192.168.0.38,4139,168.126.63.1,53,UDP,2,222,330,1,81,1,141,268.448849,0.006581,98465,171402
192.168.0.38,56526,172.217.25.163,443,UDP,38,19828,331,19,12429,19,7399,268.457288,0.835442,119017,70851
192.168.0.38,6143,168.126.63.1,53,UDP,2,172,332,1,78,1,94,268.74459,0.005479,113889,137251
192.168.0.38,60700,168.126.63.1,53,UDP,2,224,333,1,78,1,146,268.744629,0.005439,114726,214745
192.168.0.38,54807,34.104.35.123,80,TCP,33,27808,89,12,1173,21,26635,268.750335,24.220747,387,8797
192.168.0.38,5353,192.168.0.67,5353,UDP,3,1317,334,3,1317,0,0,270.923174,211.996314,49,0
192.168.0.38,35903,168.126.63.2,53,UDP,2,182,335,1,83,1,99,271.017886,0.005053,131407,156738
192.168.0.38,13162,168.126.63.2,53,UDP,2,226,336,1,83,1,143,271.01796,0.00498,,
192.168.0.38,54403,142.250.76.142,443,UDP,19,8098,337,10,3747,9,4351,271.026543,0.259883,115344,133937
192.168.0.38,54645,168.126.63.1,53,UDP,2,194,338,1,89,1,105,272.509559,0.004813,,
192.168.0.38,8983,168.126.63.1,53,UDP,2,238,339,1,89,1,149,272.509643,0.004728,,
192.168.0.38,54796,142.250.206.227,443,UDP,19,6645,340,9,2301,10,4344,272.515069,0.215126,85568,161542
192.168.0.38,55124,142.250.207.99,443,UDP,12,5618,341,6,1755,6,3863,272.804457,0.135539,103586,228008
192.168.0.38,51555,142.250.206.195,443,UDP,12,5619,342,6,1756,6,3863,272.80488,0.143029,98217,216068
192.168.0.38,63784,239.255.255.250,1900,UDP,4,872,343,4,872,0,0,273.203387,3.017014,2312,0
192.168.0.38,36481,168.126.63.2,53,UDP,2,164,344,1,74,1,90,273.250265,0.039277,15072,18331
192.168.0.38,9922,168.126.63.2,53,UDP,2,244,345,1,74,1,170,273.25043,0.039111,15136,34772
192.168.0.38,58453,35.244.233.98,443,UDP,2076,2129591,346,335,35604,1741,2093987,273.290036,2.808765,101408,5964150
192.168.0.38,25504,168.126.63.2,53,UDP,2,184,347,1,84,1,100,273.748002,0.005297,126864,151028
192.168.0.38,1242,168.126.63.2,53,UDP,2,225,348,1,84,1,141,273.748046,0.005253,127926,214734
192.168.0.38,64607,168.126.63.2,53,UDP,2,230,349,1,83,1,147,273.74831,0.004989,,
192.168.0.38,45581,168.126.63.2,53,UDP,2,226,350,1,83,1,143,273.74835,0.006933,95773,165007
192.168.0.38,46216,168.126.63.2,53,UDP,2,483,351,1,82,1,401,273.748418,0.004882,,
192.168.0.38,44467,168.126.63.2,53,UDP,2,221,352,1,82,1,139,273.748454,0.05988,10955,18570
192.168.0.38,54808,142.250.206.206,443,TCP,17,7521,90,9,1197,8,6324,273.754093,19.218757,498,2632
192.168.0.38,53335,168.126.63.2,53,UDP,2,197,353,1,75,1,122,273.755234,0.006386,93955,152834
192.168.0.38,3984,168.126.63.2,53,UDP,2,231,354,1,75,1,156,273.755339,0.007138,84057,174838
192.168.0.38,64472,64.233.187.155,443,UDP,15,8467,355,7,1847,8,6620,273.755856,0.225021,65664,235355
192.168.0.38,56562,34.64.4.48,443,UDP,100,69720,356,40,6283,60,63437,273.760741,0.409172,122843,1240299
192.168.0.38,35377,168.126.63.2,53,UDP,2,258,357,1,75,1,183,273.877702,0.005793,103573,252718
192.168.0.38,23802,168.126.63.2,53,UDP,2,307,358,1,75,1,232,273.877746,0.005748,104384,322894
192.168.0.38,54809,23.206.175.153,443,TCP,35,10507,91,17,2302,18,8205,273.883774,19.059396,966,3443
192.168.0.38,54247,168.126.63.2,53,UDP,2,186,359,1,85,1,101,273.908301,0.038959,17454,20739
192.168.0.38,63058,168.126.63.2,53,UDP,2,266,360,1,85,1,181,273.908344,0.040599,16749,35665
192.168.0.38,55761,35.190.26.106,443,UDP,1418,1324158,361,232,23875,1186,1300283,273.94949,1.52861,124950,6805047
192.168.0.38,54810,23.206.175.153,443,TCP,57,48298,92,16,2261,41,46037,274.280976,18.662086,969,19734
192.168.0.38,21053,168.126.63.2,53,UDP,2,192,362,1,80,1,112,274.478189,0.004884,,
192.168.0.38,53930,168.126.63.2,53,UDP,2,489,363,1,80,1,409,274.478304,0.004769,,
192.168.0.38,42092,168.126.63.2,53,UDP,2,292,364,1,90,1,202,274.483023,0.00515,139805,313786
192.168.0.38,50964,168.126.63.2,53,UDP,2,237,365,1,90,1,147,274.483135,0.063379,11360,18555
192.168.0.38,51078,104.17.25.14,443,UDP,150,114171,366,54,7119,96,107052,274.483605,0.534174,106616,1603252
192.168.0.38,2616,168.126.63.2,53,UDP,2,284,367,1,86,1,198,274.513999,0.013417,51278,118059
192.168.0.38,3612,168.126.63.2,53,UDP,2,232,368,1,86,1,146,274.51404,0.004831,,
192.168.0.38,2885,168.126.63.2,53,UDP,2,184,369,1,84,1,100,275.624626,0.005919,113532,135157
192.168.0.38,26498,168.126.63.2,53,UDP,2,228,370,1,84,1,144,275.624654,0.064317,10448,17911
192.168.0.38,49276,34.64.4.42,443,UDP,2585,219383,371,1258,108605,1327,110778,275.643796,2462.852708,352,359
192.168.0.38,54811,34.64.4.42,443,TCP,17,7633,93,9,1197,8,6436,275.68647,17.253368,555,2984
192.168.0.7,51839,192.168.0.38,7000,TCP,13,2678,94,6,449,7,2229,280.679373,0.050995,70438,349681
192.168.0.38,53818,168.126.63.1,53,UDP,2,212,372,1,82,1,130,284.804541,0.004825,,
192.168.0.38,123,17.253.114.253,123,UDP,12,1080,373,6,540,6,540,284.81105,2871.022907,1,1
192.168.0.38,123,17.253.114.125,123,UDP,2,180,374,1,90,1,90,284.827637,0.007192,100111,100111
192.168.0.38,63000,168.126.63.1,53,UDP,2,364,375,1,76,1,288,285.709089,0.005409,112405,425956
192.168.0.38,51632,168.126.63.1,53,UDP,2,301,376,1,76,1,225,285.709205,0.005294,114846,340007
192.168.0.38,55766,168.126.63.1,53,UDP,2,249,377,1,85,1,164,285.715663,0.004964,,
192.168.0.38,54158,104.91.76.24,443,TCP,50,28171,95,19,4173,31,23998,285.722505,121.288736,275,1582
192.168.0.38,54821,168.126.63.1,53,UDP,2,190,378,1,87,1,103,286.283533,0.005132,135619,160561
192.168.0.38,57598,168.126.63.1,53,UDP,2,323,379,1,82,1,241,286.284013,0.006178,106183,312075
192.168.0.38,61978,168.126.63.1,53,UDP,2,264,380,1,82,1,182,286.284075,0.006117,107242,238025
192.168.0.38,64246,168.126.63.1,53,UDP,2,382,381,1,72,1,310,286.287401,0.004455,,
192.168.0.38,49521,168.126.63.1,53,UDP,2,320,382,1,72,1,248,286.287478,0.004377,,
192.168.0.38,64773,168.126.63.1,53,UDP,2,239,383,1,82,1,157,286.290673,0.003584,,
192.168.0.38,50233,168.126.63.1,53,UDP,2,180,384,1,82,1,98,286.290736,0.003522,,
192.168.0.38,54159,104.91.77.72,443,TCP,29,9402,96,14,1878,15,7524,286.291443,0.387653,38756,155272
192.168.0.38,61986,168.126.63.1,53,UDP,2,250,385,1,86,1,164,286.292469,0.004494,,
192.168.0.38,54160,104.75.0.186,443,TCP,24,8608,97,10,1551,14,7057,286.295626,30.760988,403,1835
192.168.0.38,54161,104.91.73.144,443,TCP,19,8184,98,9,1575,10,6609,286.299335,10.359734,1216,5103
192.168.0.38,62832,168.126.63.1,53,UDP,2,376,386,1,82,1,294,286.488682,0.004839,,
192.168.0.38,55469,168.126.63.1,53,UDP,2,443,387,1,82,1,361,286.488857,0.004663,,
192.168.0.38,65125,168.126.63.1,53,UDP,2,245,388,1,84,1,161,286.494461,0.00488,,
192.168.0.38,54162,175.207.14.49,443,TCP,22,12505,99,9,1881,13,10624,286.500533,10.158569,1481,8366
192.168.0.38,54163,23.212.13.145,443,TCP,23,8542,100,9,1485,14,7057,286.638191,30.839802,385,1830
192.168.0.38,54164,104.91.77.72,443,TCP,27,9270,101,12,1746,15,7524,286.639238,0.627722,22251,95889
192.168.0.38,49652,168.126.63.1,53,UDP,4,596,389,2,180,2,416,286.785261,4724.154569,0,0
192.168.0.38,65330,168.126.63.1,53,UDP,2,289,390,1,96,1,193,286.785331,0.005828,131777,264927
192.168.0.38,54165,104.91.76.24,443,TCP,41,18717,102,18,2365,23,16352,286.794747,0.3515,53826,372165
192.168.0.38,52024,168.126.63.1,53,UDP,2,266,391,1,95,1,171,286.914655,0.005007,151787,273217
192.168.0.38,55952,168.126.63.1,53,UDP,2,254,392,1,95,1,159,286.914725,0.004936,,
192.168.0.38,54166,17.36.202.253,443,TCP,27,13603,103,12,2002,15,11601,286.922404,1.087324,14729,85354
192.168.0.38,54167,23.212.13.145,443,TCP,25,8674,104,11,1617,14,7057,287.339503,30.834916,419,1830
192.168.0.38,54168,104.91.77.72,443,TCP,29,9402,105,14,1878,15,7524,287.340581,0.416581,36065,144490
192.168.0.38,65243,168.126.63.1,53,UDP,2,298,393,1,96,1,202,287.392757,0.01382,55571,116931
192.168.0.38,61005,168.126.63.1,53,UDP,4,484,394,2,193,2,291,287.3929,1747.167204,0,1
192.168.0.38,54169,17.253.115.201,443,TCP,28,8646,106,13,1788,15,6858,287.408356,1.789231,7994,30663
192.168.0.38,65126,168.126.63.1,53,UDP,2,296,395,1,84,1,212,287.622237,0.004935,,
192.168.0.38,54170,17.248.221.3,443,TCP,48,15175,107,19,4498,29,10677,287.6319,31.426493,1145,2717
192.168.0.38,54171,17.248.221.3,443,TCP,44,17758,108,18,6497,26,11261,287.717323,30.948019,1679,2910
192.168.0.38,54543,192.168.0.36,62758,TCP,134,49342,109,73,38236,61,11106,288.126806,2873.25632,106,30
192.168.0.38,54172,17.253.115.201,443,TCP,29,9174,110,13,1712,16,7462,289.202587,3.011047,4548,19825
192.168.0.36,5353,224.0.0.251,5353,UDP,361,124264,396,361,124264,0,0,289.292093,2933.038972,338,0
fe80::186b:ee65:7a83:72e5,5353,ff02::fb,5353,UDP,361,131250,397,361,131250,0,0,289.292093,2933.038974,357,0
192.168.0.38,5353,192.168.0.64,5353,UDP,7,7050,398,7,7050,0,0,289.501338,171.164125,329,0
192.168.0.64,52463,192.168.0.38,7000,TCP,12,2613,111,6,449,6,2164,289.537919,0.040344,89034,429109
192.168.0.38,5353,192.168.0.36,5353,UDP,14,9008,399,13,8738,1,270,289.846712,2891.66407,24,0
192.168.0.38,63644,168.126.63.1,53,UDP,2,264,400,1,77,1,187,290.754963,0.005799,106225,257975
192.168.0.38,56629,168.126.63.1,53,UDP,2,215,401,1,77,1,138,290.75517,0.005593,110137,197389
192.168.0.38,49249,168.126.63.1,53,UDP,2,256,402,1,91,1,165,290.761523,0.005391,135039,244852
192.168.0.38,54173,15.164.151.105,443,TCP,50,14535,112,25,7131,25,7404,290.77615,66.681677,855,888
192.168.0.38,49357,66.22.228.211,50001,UDP,17773,20298660,403,17040,20214576,733,84084,293.460412,60.001658,2695202,11210
192.168.0.38,61423,168.126.63.1,53,UDP,2,344,404,1,75,1,269,296.237402,0.005741,104511,374847
192.168.0.38,57878,168.126.63.1,53,UDP,2,284,405,1,75,1,209,296.23754,0.005605,107047,298305
192.168.0.38,60470,168.126.63.1,53,UDP,2,288,406,1,106,1,182,296.24406,0.005309,159728,274251
192.168.0.38,54174,52.232.209.85,443,TCP,26,8774,113,12,2384,14,6390,296.264407,62.190479,306,821
192.168.0.38,10718,168.126.63.2,53,UDP,2,166,407,1,75,1,91,304.251993,0.005833,102863,124807
192.168.0.38,62284,168.126.63.2,53,UDP,2,210,408,1,75,1,135,304.252062,0.005763,104112,187402
192.168.0.38,50969,142.250.206.227,443,UDP,30,8282,409,14,3007,16,5275,304.258984,1.590284,15126,26536
192.168.0.38,59640,168.126.63.2,53,UDP,2,208,410,1,79,1,129,304.259474,0.006627,95367,155726
192.168.0.38,40261,168.126.63.2,53,UDP,2,232,411,1,79,1,153,304.25954,0.006561,96326,186556
192.168.0.38,50506,142.250.206.206,443,UDP,123,50343,412,55,9030,68,41313,304.266639,62.459589,1156,5291
192.168.0.38,35703,168.126.63.2,53,UDP,2,164,413,1,74,1,90,318.766367,0.004579,,
192.168.0.38,65296,168.126.63.2,53,UDP,2,173,414,1,74,1,99,318.766396,0.004549,,
192.168.0.38,63532,142.250.206.196,443,UDP,1188,575896,415,446,65179,742,510717,318.771558,35.390102,14733,115448
192.168.0.38,65405,168.126.63.2,53,UDP,2,443,416,1,86,1,357,319.527801,0.00625,110080,456960
192.168.0.38,54998,168.126.63.2,53,UDP,2,232,417,1,86,1,146,319.527921,0.006131,112216,190507
192.168.0.38,53115,172.217.25.174,443,UDP,61,42469,418,24,5217,37,37252,323.309854,13.179691,3166,22611
192.168.0.38,26885,168.126.63.2,53,UDP,2,166,419,1,75,1,91,323.532356,0.005558,107952,130982
192.168.0.38,5288,168.126.63.2,53,UDP,2,207,420,1,75,1,132,323.532421,0.005493,109229,192244
192.168.0.38,57334,172.217.25.163,443,UDP,12,5619,421,6,1756,6,3863,323.538838,0.137468,102191,224808
192.168.0.38,57430,142.250.76.142,443,UDP,19,6876,422,9,2462,10,4414,325.235772,0.261261,75388,135159
fe80::44d:c116:d84c:eb23,5353,ff02::fb,5353,UDP,33,9571,423,33,9571,0,0,331.583268,83.866205,912,0
fe80::102a:21ec:c118:a887,5353,fe80::44d:c116:d84c:eb23,5353,UDP,1,459,424,1,459,0,0,331.773218,0,,
192.168.0.37,5353,224.0.0.251,5353,UDP,26,7123,425,26,7123,0,0,334.761059,80.688413,706,0
192.168.0.38,5353,192.168.0.37,5353,UDP,3,1639,426,3,1639,0,0,334.932941,75.78167,173,0
192.168.0.38,58937,142.250.206.227,443,UDP,12,5622,427,6,1759,6,3863,336.437598,0.142411,98812,217005
192.168.0.38,13869,168.126.63.2,53,UDP,2,198,428,1,79,1,119,342.59541,0.014233,44403,66886
192.168.0.38,52088,168.126.63.2,53,UDP,2,242,429,1,79,1,163,342.595527,0.005405,116928,241258
192.168.0.38,62337,172.217.25.174,443,UDP,29,10382,430,13,4865,16,5517,342.610621,28.820362,1350,1531
192.168.0.38,49060,168.126.63.2,53,UDP,2,446,431,1,91,1,355,344.872646,0.005617,129606,505607
192.168.0.38,64706,168.126.63.2,53,UDP,2,242,432,1,91,1,151,344.872715,0.005547,131242,217775
192.168.0.38,49394,142.250.206.234,443,UDP,19,6895,433,9,2465,10,4430,344.878834,0.251457,78422,140938
192.168.0.38,59935,66.22.228.211,50001,UDP,17842,20401737,434,17107,20317349,735,84388,353.459717,59.975534,2710084,11256
192.168.0.54,60945,192.168.0.38,7000,TCP,12,2613,114,6,449,6,2164,365.596913,0.048784,73630,354870
192.168.0.38,3776,168.126.63.2,53,UDP,2,182,435,1,83,1,99,371.175318,0.005306,125141,149264
192.168.0.38,27239,168.126.63.2,53,UDP,2,226,436,1,83,1,143,371.1754,0.005225,127081,218947
192.168.0.7,51852,192.168.0.38,7000,TCP,12,2612,115,6,449,6,2163,391.787367,0.046916,76562,368829
192.168.0.38,57853,239.255.255.250,1900,UDP,4,872,437,4,872,0,0,393.141309,3.013356,2315,0
192.168.0.38,22430,168.126.63.2,53,UDP,2,208,438,1,79,1,129,397.715407,0.0055,114909,187636
192.168.0.38,34083,168.126.63.2,53,UDP,2,242,439,1,79,1,163,397.715488,0.005419,116626,240634
192.168.0.38,60472,142.250.206.206,443,UDP,20,9366,440,10,4135,10,5231,397.721485,0.330187,100185,126740
192.168.0.38,4284,168.126.63.2,53,UDP,2,198,441,1,91,1,107,406.264935,0.005572,130653,153625
192.168.0.38,21391,168.126.63.2,53,UDP,2,242,442,1,91,1,151,406.264983,0.005525,131764,218642
192.168.0.38,61436,172.217.25.170,443,UDP,19,6890,443,9,2460,10,4430,406.271007,0.255906,76903,138488
192.168.0.37,50252,192.168.0.38,7000,TCP,12,2613,116,6,449,6,2164,413.100715,0.036494,98427,474379
192.168.0.38,62555,66.22.228.211,50001,UDP,17782,20336505,444,17049,20252501,733,84004,413.460151,59.974738,2701470,11205
192.168.0.38,22669,168.126.63.2,53,UDP,2,421,445,1,75,1,346,426.000942,0.006013,99783,460335
192.168.0.38,56364,168.126.63.2,53,UDP,2,210,446,1,75,1,135,426.001028,0.005928,101214,182186
192.168.0.38,51270,142.250.76.131,443,UDP,26,7957,447,12,2865,14,5092,426.0081,0.180734,126816,225392
192.168.0.42,59901,192.168.0.38,7000,TCP,12,2613,117,6,449,6,2164,426.973364,0.054322,66124,318692
192.168.0.38,61340,142.250.206.206,443,UDP,20,9410,448,10,4135,10,5275,428.48213,0.317357,104235,132973
192.168.0.38,61000,172.217.25.174,443,UDP,19,6875,449,9,2461,10,4414,431.130552,0.266454,73888,132525
fe80::89:17d7:434e:a333,5353,ff02::fb,5353,UDP,45,4793,450,45,4793,0,0,436.236344,31.846625,1204,0
169.254.194.250,137,169.254.255.255,137,UDP,12,1320,451,12,1320,0,0,444.531188,2.252975,4687,0
169.254.194.250,5353,224.0.0.251,5353,UDP,2,200,452,2,200,0,0,444.531189,0.101946,15694,0
192.168.0.44,5353,224.0.0.251,5353,UDP,156,47428,453,156,47428,0,0,448.626909,4557.528275,83,0
fe80::1872:9dd6:cfe2:da07,5353,ff02::fb,5353,UDP,155,51147,454,155,51147,0,0,448.62691,4557.528342,89,0
192.168.0.38,5353,192.168.0.44,5353,UDP,11,4505,455,9,3951,2,554,448.765509,3777.349894,8,1
192.168.0.55,137,192.168.0.255,137,UDP,15,1650,456,15,1650,0,0,449.548841,2.45771,5370,0
192.168.0.55,5353,224.0.0.251,5353,UDP,37,3141,457,37,3141,0,0,449.651346,18.431623,1363,0
192.168.0.38,12989,168.126.63.2,53,UDP,2,258,458,1,85,1,173,457.425946,0.006124,111038,225996
192.168.0.38,19839,168.126.63.2,53,UDP,2,254,459,1,85,1,169,457.426015,0.006054,112322,223323
192.168.0.38,57371,216.239.32.180,443,UDP,21,8501,460,10,3586,11,4915,457.432892,0.281213,102015,139822
192.168.0.38,55447,142.250.206.206,443,UDP,32,11554,461,17,5162,15,6392,458.521229,1.223894,33741,41781
192.168.0.64,52464,192.168.0.38,7000,TCP,12,2613,118,6,449,6,2164,460.543313,0.044321,81045,390604
192.168.0.38,38480,168.126.63.2,53,UDP,4,440,462,2,170,2,270,468.10582,881.790513,1,2
192.168.0.38,60972,168.126.63.2,53,UDP,2,242,463,1,91,1,151,468.105873,0.004967,,
192.168.0.38,50153,142.250.206.234,443,UDP,19,6894,464,9,2464,10,4430,468.111266,0.265661,74199,133403
192.168.0.38,54958,66.22.228.211,50001,UDP,17877,20420453,465,17140,20335753,737,84700,473.45853,60.039817,2709635,11285
192.168.0.38,46963,168.126.63.2,53,UDP,2,182,466,1,83,1,99,485.864512,0.006218,106786,127372
192.168.0.38,63921,168.126.63.2,53,UDP,2,223,467,1,83,1,140,485.864565,0.006164,107722,181700
192.168.0.38,63715,142.250.207.110,443,UDP,27,7697,468,13,2969,14,4728,485.871389,20.706598,1147,1826
192.168.0.38,56745,142.250.206.206,443,UDP,20,9350,469,10,4137,10,5213,491.003493,0.334098,99060,124825
192.168.0.52,5353,224.0.0.251,5353,UDP,8,1412,470,8,1412,0,0,494.297264,39.117542,288,0
fe80::31:37f0:1d20:6e17,5353,ff02::fb,5353,UDP,8,1572,471,8,1572,0,0,494.297265,39.117542,321,0
fe80::31:37f0:1d20:6e17,51317,fe80::102a:21ec:c118:a887,54543,TCP,2,276,119,1,202,1,74,494.584099,0.103504,15612,5719
192.168.0.62,5353,224.0.0.251,5353,UDP,25,5342,472,25,5342,0,0,495.628925,4528.756337,9,0
fe80::1044:2422:4918:ea88,5353,ff02::fb,5353,UDP,25,5842,473,25,5842,0,0,495.628925,4528.756339,10,0
192.168.0.38,5353,192.168.0.96,5353,UDP,26,29302,474,25,29035,1,267,500.502528,2681.164843,86,0
192.168.0.96,54659,192.168.0.38,7000,TCP,12,2613,120,6,449,6,2164,500.861773,0.076784,46780,225463
fe80::31:37f0:1d20:6e17,51343,fe80::102a:21ec:c118:a887,54543,TCP,22,9705,121,11,5081,11,4624,506.791555,0.039902,1018695,927071
192.168.0.38,60925,239.255.255.250,1900,UDP,4,872,475,4,872,0,0,513.146419,3.022036,2308,0
192.168.0.20,5353,224.0.0.251,5353,UDP,68,19407,476,68,19407,0,0,525.222242,2700.793639,57,0
fe80::18e1:3022:4328:c167,5353,ff02::fb,5353,UDP,68,20767,477,68,20767,0,0,525.222243,2700.793639,61,0
192.168.0.38,5353,192.168.0.20,5353,UDP,4,4680,478,4,4680,0,0,525.305807,1832.982081,20,0
192.168.0.38,51819,168.126.63.1,53,UDP,2,240,479,1,82,1,158,526.351349,0.005765,113790,219254
192.168.0.38,63284,168.126.63.1,53,UDP,2,292,480,1,82,1,210,526.352442,0.004673,,
192.168.0.38,54175,17.248.221.1,443,TCP,37,19768,122,16,6650,21,13118,526.361897,31.272705,1701,3355
192.168.0.38,58845,168.126.63.1,53,UDP,2,293,481,1,87,1,206,526.595789,0.005365,129729,307176
192.168.0.38,57894,168.126.63.1,53,UDP,2,345,482,1,87,1,258,526.59587,0.005284,131718,390613
192.168.0.38,54176,17.248.221.1,443,TCP,44,28098,123,17,5457,27,22641,526.597778,62.290574,700,2907
192.168.0.38,50613,168.126.63.1,53,UDP,2,254,483,1,89,1,165,526.601829,0.004971,,
192.168.0.38,54177,17.248.221.8,443,TCP,25,11662,124,11,2592,14,9070,526.608576,31.270614,663,2320
192.168.0.38,54178,17.248.221.1,443,TCP,27,15774,125,11,3347,16,12427,526.630105,13.493846,1984,7367
192.168.0.38,55804,168.126.63.1,53,UDP,4,532,484,2,195,2,337,526.635366,541.224704,2,4
192.168.0.38,64286,168.126.63.1,53,UDP,2,326,485,1,81,1,245,526.635455,0.004036,,
192.168.0.38,54179,17.248.221.1,443,TCP,28,13862,126,11,2161,17,11701,526.638177,31.33475,551,2987
192.168.0.38,65418,168.126.63.1,53,UDP,2,240,486,1,82,1,158,526.640947,0.003838,,
192.168.0.38,54180,17.248.221.1,443,TCP,25,10573,127,11,2717,14,7856,526.647366,31.325564,693,2006
192.168.0.38,54181,17.248.221.1,443,TCP,36,22599,128,14,4005,22,18594,526.756091,62.132543,515,2394
192.168.0.38,54182,17.248.221.1,443,TCP,22,9114,129,10,2485,12,6629,526.986383,30.894896,643,1716
192.168.0.38,58905,168.126.63.1,53,UDP,2,248,487,1,86,1,162,527.063355,0.005614,122550,230851
192.168.0.38,54866,168.126.63.1,53,UDP,2,300,488,1,86,1,214,527.063438,0.005531,124389,309528
192.168.0.38,54183,17.248.221.11,443,TCP,36,17603,130,16,6514,20,11089,527.072567,62.280198,836,1424
192.168.0.38,54184,17.248.221.1,443,TCP,28,15183,131,11,2593,17,12590,527.202461,30.678818,676,3283
192.168.0.38,52711,168.126.63.1,53,UDP,2,265,489,1,73,1,192,527.213064,0.004447,,
192.168.0.38,51017,168.126.63.1,53,UDP,2,221,490,1,73,1,148,527.21371,0.005136,113707,230529
192.168.0.38,53197,168.126.63.1,53,UDP,2,254,491,1,89,1,165,527.220437,0.00433,,
192.168.0.38,54185,17.32.194.34,443,TCP,21,11118,132,11,3881,10,7237,527.226057,12.897956,2407,4488
192.168.0.38,50805,168.126.63.2,53,UDP,2,208,492,1,79,1,129,527.462227,0.00634,99684,162776
192.168.0.38,5172,168.126.63.2,53,UDP,2,242,493,1,79,1,163,527.46231,0.006259,100974,208339
192.168.0.38,51150,142.250.206.206,443,UDP,20,9461,494,10,4138,10,5323,527.46918,0.326979,101241,130234
192.168.0.38,54186,17.248.221.9,443,TCP,45,25354,133,22,9187,23,16167,527.591833,12.528857,5866,10323
192.168.0.38,54066,168.126.63.1,53,UDP,2,308,495,1,81,1,227,527.902979,0.005345,121234,339756
192.168.0.38,58314,168.126.63.1,53,UDP,2,248,496,1,81,1,167,527.903059,0.005265,123076,253751
192.168.0.38,57614,168.126.63.1,53,UDP,2,258,497,1,91,1,167,527.912454,0.004961,,
192.168.0.38,54187,17.42.251.13,443,TCP,26,13160,134,14,3977,12,9183,527.919329,61.104463,520,1202
192.168.0.38,54188,17.248.221.9,443,TCP,24,13263,135,11,3417,13,9846,528.067221,12.053417,2267,6534
192.168.0.38,54817,192.168.0.7,7000,TCP,12,2539,136,6,449,6,2090,528.217204,0.273179,13148,61205
192.168.0.38,9043,168.126.63.2,53,UDP,2,198,498,1,91,1,107,529.402699,0.063368,11488,13508
192.168.0.38,33358,168.126.63.2,53,UDP,2,232,499,1,91,1,141,529.402831,0.063236,11512,17837
192.168.0.38,60770,142.250.207.106,443,UDP,19,6894,500,9,2464,10,4430,529.467161,0.260166,75767,136220
192.168.0.38,58433,168.126.63.1,53,UDP,2,364,501,1,73,1,291,529.708534,0.004867,,
192.168.0.38,62895,168.126.63.1,53,UDP,2,302,502,1,73,1,229,529.708615,0.004786,,
192.168.0.38,59194,168.126.63.1,53,UDP,2,248,503,1,85,1,163,529.714495,0.005608,121255,232524
192.168.0.38,54189,23.201.36.209,443,TCP,29,9743,137,14,1799,15,7944,529.725322,0.628831,22886,101063
192.168.0.38,53378,168.126.63.1,53,UDP,2,186,504,1,85,1,101,531.732746,0.005344,127245,151197
192.168.0.38,54190,104.91.76.24,443,TCP,56,41572,138,20,4000,36,37572,531.748415,120.440077,265,2495
192.168.0.38,58423,168.126.63.1,53,UDP,2,252,505,1,96,1,156,531.765629,0.006041,127131,206588
192.168.0.38,55728,168.126.63.1,53,UDP,2,208,506,1,96,1,112,531.76571,0.00596,128859,150335
192.168.0.38,58826,142.250.206.225,443,UDP,37,20148,507,19,6232,18,13916,531.789581,0.912132,54658,122052
192.168.0.38,55470,168.126.63.1,53,UDP,2,415,508,1,74,1,341,532.177658,0.004802,,
192.168.0.38,55541,168.126.63.1,53,UDP,2,352,509,1,74,1,278,532.177808,0.004651,,
192.168.0.38,54191,104.91.76.24,443,TCP,30,11521,139,13,2167,17,9354,532.184549,120.557375,143,620
192.168.0.38,61370,142.250.206.225,443,UDP,33,16374,510,17,5196,16,11178,532.708417,0.639999,64950,139725
192.168.0.38,57333,168.126.63.1,53,UDP,2,379,511,1,88,1,291,533.205706,0.00552,127536,421739
192.168.0.38,58660,168.126.63.1,53,UDP,2,346,512,1,88,1,258,533.205862,0.005365,131220,384715
192.168.0.38,54714,168.126.63.1,53,UDP,2,258,513,1,92,1,166,533.212085,0.004557,,
192.168.0.38,54192,17.253.75.204,443,TCP,20,8500,140,9,2287,11,6213,533.219979,6.890307,2655,7213
192.168.0.38,55278,168.126.63.1,53,UDP,2,305,514,1,95,1,210,533.223823,0.004352,,
192.168.0.38,53030,168.126.63.1,53,UDP,2,340,515,1,95,1,245,533.22389,0.004285,,
192.168.0.38,58725,168.126.63.1,53,UDP,2,245,516,1,84,1,161,533.228872,0.004813,,
192.168.0.38,54193,23.43.165.27,443,TCP,43,16721,141,19,5298,24,11423,533.235287,20.31421,2086,4498
192.168.0.38,53611,142.250.206.225,443,UDP,32,17344,517,16,5301,16,12043,533.32938,0.573719,73917,167928
192.168.0.38,60941,66.22.228.211,50001,UDP,17718,20238664,518,16990,20155150,728,83514,533.458184,59.98363,2688086,11138
192.168.0.38,52687,168.126.63.1,53,UDP,2,291,519,1,95,1,196,533.504757,0.231915,3277,6761
192.168.0.38,50049,168.126.63.1,53,UDP,2,231,520,1,95,1,136,533.504834,0.005281,143912,206021
192.168.0.38,54194,17.120.252.47,443,TCP,35,13016,142,16,5178,19,7838,533.643773,61.777473,670,1014
192.168.0.38,55760,168.126.63.1,53,UDP,2,272,521,1,98,1,174,533.737134,0.070703,11088,19687
192.168.0.38,57740,142.250.206.225,443,UDP,41,22307,522,20,5823,21,16484,533.909534,1.815086,25664,72653
192.168.0.38,63265,142.250.206.202,443,UDP,1946,392521,523,873,93238,1073,299283,534.673288,2661.244936,280,899
192.168.0.38,55768,168.126.63.1,53,UDP,2,203,524,1,75,1,128,534.746727,0.00391,,
192.168.0.38,61222,168.126.63.1,53,UDP,2,318,525,1,95,1,223,534.747801,0.004012,,
192.168.0.38,53230,168.126.63.1,53,UDP,2,397,526,1,92,1,305,534.748573,0.005383,136726,453278
192.168.0.38,56312,168.126.63.1,53,UDP,2,308,527,1,84,1,224,534.749002,0.004955,,
192.168.0.38,52084,168.126.63.1,53,UDP,2,296,528,1,84,1,212,535.105592,0.004024,,
192.168.0.38,54195,142.250.206.225,443,TCP,15,9212,143,6,901,9,8311,535.184515,0.117103,61552,567773
192.168.0.38,54196,17.120.252.47,443,TCP,31,12737,144,15,5112,16,7625,535.22874,60.190286,679,1013
192.168.0.38,54197,17.120.252.47,443,TCP,32,15157,145,15,6477,17,8680,535.229136,60.195084,860,1153
192.168.0.38,50965,142.250.206.225,443,UDP,36,17887,529,19,5710,17,12177,535.73095,0.644221,70907,151215
192.168.0.38,55134,142.250.206.225,443,UDP,42,29015,530,18,7554,24,21461,536.380196,0.718446,84114,238971
192.168.0.7,51862,192.168.0.38,7000,TCP,14,4204,146,7,527,7,3677,536.722558,0.088596,47586,332024
192.168.0.38,54141,168.126.63.1,53,UDP,2,340,531,1,86,1,254,542.908884,0.005558,123785,365599
192.168.0.38,64652,168.126.63.1,53,UDP,2,277,532,1,86,1,191,542.909019,0.005424,126843,281710
192.168.0.38,64057,168.126.63.1,53,UDP,2,264,533,1,94,1,170,542.910877,0.00607,123887,224052
192.168.0.38,51783,168.126.63.1,53,UDP,2,204,534,1,94,1,110,542.910957,0.00599,125542,146911
192.168.0.38,50894,168.126.63.1,53,UDP,2,251,535,1,86,1,165,542.915125,0.005651,121748,233586
192.168.0.38,63530,168.126.63.1,53,UDP,2,188,536,1,86,1,102,542.91521,0.005565,123629,146630
192.168.0.38,54198,17.242.164.12,443,TCP,20,6270,147,10,1770,10,4500,542.919891,31.032411,456,1160
192.168.0.38,54199,104.91.76.215,443,TCP,28,9292,148,13,1916,15,7376,542.922339,31.086571,493,1898
192.168.0.38,57363,168.126.63.1,53,UDP,2,282,537,1,103,1,179,543.194382,0.005051,163136,283508
192.168.0.38,53553,168.126.63.1,53,UDP,2,222,538,1,103,1,119,543.194557,0.004875,,
192.168.0.38,54200,17.57.168.5,443,TCP,12,4596,149,6,925,6,3671,543.201065,0.812085,9112,36163
192.168.0.38,65291,139.178.159.31,443,UDP,240,32068,539,122,17054,118,15014,543.55964,991.604228,137,121
192.168.0.38,58798,142.250.207.110,443,UDP,19,8101,540,10,3750,9,4351,545.081274,0.258348,116122,134732
192.168.0.38,31962,168.126.63.2,53,UDP,2,166,541,1,75,1,91,549.101529,0.005156,116369,141194
192.168.0.38,11162,168.126.63.2,53,UDP,2,210,542,1,75,1,135,549.101567,0.005117,117256,211061
192.168.0.38,54193,142.250.206.195,443,UDP,39,9351,543,19,3571,20,5780,549.107726,35.67578,800,1296
192.168.0.38,63120,142.250.206.206,443,UDP,213,159051,544,149,141304,64,17747,559.071966,31.26068,36161,4541
fe80::8ce:5628:e10d:a7cf,5353,ff02::fb,5353,UDP,405,136489,545,405,136489,0,0,561.984354,3664.688973,297,0
fe80::102a:21ec:c118:a887,5353,fe80::8ce:5628:e10d:a7cf,5353,UDP,3,1840,546,1,1190,2,650,562.121565,4442.925507,2,1
fe80::1012:ac9d:1bd4:5d9a,5353,ff02::fb,5353,UDP,14,2785,547,14,2785,0,0,563.007972,825.039066,27,0
fe80::102a:21ec:c118:a887,5353,fe80::1012:ac9d:1bd4:5d9a,5353,UDP,1,1190,548,1,1190,0,0,563.092586,0,,
192.168.0.57,5353,224.0.0.251,5353,UDP,395,125570,549,395,125570,0,0,565.977576,3660.695748,274,0
192.168.0.38,56700,35.244.233.98,443,UDP,11,7607,550,5,2941,6,4666,566.016992,0.077419,303904,482155
192.168.0.38,54820,35.244.233.98,443,TCP,62,14056,150,30,5222,32,8834,566.031616,610.227025,68,115
192.168.0.38,5353,192.168.0.57,5353,UDP,26,28965,551,26,28965,0,0,566.256381,2572.962844,90,0
192.168.0.59,5353,224.0.0.251,5353,UDP,12,1859,552,12,1859,0,0,566.899654,821.147382,18,0
192.168.0.38,5353,192.168.0.59,5353,UDP,1,245,553,1,245,0,0,566.978272,0,,
fe80::102a:21ec:c118:a887,3722,fe80::31:37f0:1d20:6e17,3722,UDP,1,66,554,1,66,0,0,570.196777,0,,
192.168.0.38,24439,168.126.63.2,53,UDP,2,166,555,1,75,1,91,574.719143,0.005486,109369,132701
192.168.0.38,27733,168.126.63.2,53,UDP,2,200,556,1,75,1,125,574.719192,0.005436,110375,183958
192.168.0.38,55555,168.126.63.2,53,UDP,2,412,557,1,74,1,338,580.40424,0.039905,14835,67760
192.168.0.38,57874,168.126.63.2,53,UDP,2,173,558,1,74,1,99,580.404301,0.006099,97065,129857
192.168.0.38,50299,142.250.206.196,443,UDP,1612,1308308,559,397,66579,1215,1241729,580.444771,39.892494,13351,249015
192.168.0.47,55290,192.168.0.38,7000,TCP,12,2613,151,6,449,6,2164,584.032006,0.090381,39742,191544
192.168.0.38,27583,168.126.63.2,53,UDP,2,188,560,1,86,1,102,584.458535,0.005402,127360,151055
192.168.0.38,25677,168.126.63.2,53,UDP,2,232,561,1,86,1,146,584.458869,0.005067,135780,230511
192.168.0.38,4986,168.126.63.2,53,UDP,2,236,562,1,85,1,151,584.459819,0.004118,,
192.168.0.38,50276,168.126.63.2,53,UDP,2,280,563,1,85,1,195,584.460003,0.003935,,
192.168.0.38,53774,142.250.76.142,443,UDP,64,24751,564,29,4682,35,20069,584.464629,12.86045,2912,12484
192.168.0.38,52387,142.250.206.193,443,UDP,25,16390,565,11,3649,14,12741,584.465249,0.186028,156922,547917
192.168.0.38,54821,142.250.206.193,443,TCP,34,11761,152,16,1587,18,10174,584.527082,290.192896,43,280
192.168.0.38,50424,168.126.63.2,53,UDP,2,195,566,1,74,1,121,586.788248,0.004835,,
192.168.0.38,13186,168.126.63.2,53,UDP,2,229,567,1,74,1,155,586.788284,0.004797,,
192.168.0.38,53187,172.217.25.174,443,UDP,117,77644,568,48,7601,69,70043,586.793629,37.498638,1621,14943
192.168.0.38,48698,168.126.63.2,53,UDP,2,166,569,1,75,1,91,587.008151,0.004788,,
192.168.0.38,64315,168.126.63.2,53,UDP,2,207,570,1,75,1,132,587.008194,0.004745,,
192.168.0.38,65401,172.217.25.163,443,UDP,12,5620,571,6,1757,6,3863,587.013459,0.145447,96640,212476
192.168.0.38,28171,168.126.63.2,53,UDP,2,198,572,1,91,1,107,590.316293,0.005021,144991,170483
192.168.0.38,50348,168.126.63.2,53,UDP,2,242,573,1,91,1,151,590.316352,0.004961,,
192.168.0.38,58597,142.250.207.106,443,UDP,96,46321,574,41,7149,55,39172,590.322109,35.835896,1595,8744
192.168.0.38,64102,66.22.228.211,50001,UDP,17777,20308032,575,17040,20223624,737,84408,593.45837,59.974326,2697637,11259
192.168.0.38,56749,168.126.63.2,53,UDP,2,238,576,1,71,1,167,596.785042,0.004987,,
192.168.0.38,19948,168.126.63.2,53,UDP,2,202,577,1,71,1,131,596.785096,0.004934,,
192.168.0.38,60000,142.250.206.214,443,UDP,20,10582,578,9,2545,11,8037,596.790604,0.125962,161636,510439
192.168.0.38,22543,168.126.63.2,53,UDP,2,182,579,1,83,1,99,597.001673,0.00707,93917,112022
192.168.0.38,34966,168.126.63.2,53,UDP,2,226,580,1,83,1,143,597.00171,0.007034,94398,162638
192.168.0.38,54337,172.217.161.238,443,UDP,19,6876,581,9,2462,10,4414,597.009199,0.263496,74748,134013
192.168.0.38,51167,168.126.63.1,53,UDP,2,190,582,1,87,1,103,597.158365,0.003683,,
192.168.0.38,42136,168.126.63.1,53,UDP,2,234,583,1,87,1,147,597.158411,0.003638,,
192.168.0.38,64658,142.250.207.106,443,UDP,18,7207,584,8,2699,10,4508,597.162527,0.131854,163756,273514
192.168.0.38,55682,168.126.63.2,53,UDP,2,258,585,1,81,1,177,597.727639,0.005341,121325,265118
192.168.0.38,2662,168.126.63.2,53,UDP,2,222,586,1,81,1,141,597.727679,0.005302,122218,212749
192.168.0.59,52370,192.168.0.38,7000,TCP,12,2613,153,6,449,6,2164,601.516613,0.040421,88864,428292
192.168.0.38,14906,168.126.63.2,53,UDP,2,208,587,1,79,1,129,607.203944,0.005031,125621,205128
192.168.0.38,17702,168.126.63.2,53,UDP,2,242,588,1,79,1,163,607.203994,0.004982,,
192.168.0.38,54515,142.250.207.110,443,UDP,43,15373,589,19,8575,24,6798,607.209533,29.383634,2334,1850
192.168.0.7,51867,192.168.0.38,7000,TCP,12,2612,154,6,449,6,2163,611.719582,0.046296,77587,373768
192.168.0.38,41754,168.126.63.2,53,UDP,2,421,590,1,75,1,346,618.994715,0.005497,109150,503547
192.168.0.38,39225,168.126.63.2,53,UDP,2,210,591,1,75,1,135,618.994778,0.005435,110395,198712
192.168.0.38,53661,172.217.25.163,443,UDP,12,5619,592,6,1756,6,3863,618.995126,0.139108,100986,222158
192.168.0.38,54435,142.250.76.131,443,UDP,12,5622,593,6,1759,6,3863,619.000848,0.133419,105472,231631
192.168.0.38,56895,142.250.206.206,443,UDP,20,9453,594,10,4132,10,5321,620.449874,0.32842,100651,129614
192.168.0.38,38953,168.126.63.1,53,UDP,2,211,595,1,83,1,128,624.99896,0.005461,121589,187511
192.168.0.38,25453,168.126.63.1,53,UDP,2,245,596,1,83,1,162,624.999012,0.00541,122735,239556
192.168.0.38,24091,168.126.63.2,53,UDP,2,225,597,1,80,1,145,625.001211,0.006598,96999,175810
192.168.0.38,65177,168.126.63.2,53,UDP,2,276,598,1,80,1,196,625.001248,0.00656,97560,239024
192.168.0.38,54180,172.217.161.238,443,UDP,21,9109,599,10,4613,11,4496,625.004981,0.223354,165226,161035
192.168.0.38,54822,211.249.222.33,443,TCP,45,29332,155,20,6586,25,22746,625.008989,55.679516,946,3268
192.168.0.38,36489,168.126.63.2,53,UDP,2,236,600,1,80,1,156,625.364985,0.105911,6042,11783
192.168.0.38,35479,168.126.63.2,53,UDP,2,298,601,1,80,1,218,625.365081,0.006728,95124,259215
192.168.0.38,59989,168.126.63.2,53,UDP,2,301,602,1,74,1,227,625.367728,0.005769,102617,314785
192.168.0.38,54910,168.126.63.2,53,UDP,2,289,603,1,74,1,215,625.367769,0.005729,103333,300226
192.168.0.38,54823,211.56.99.89,443,TCP,38,7743,156,19,2812,19,4931,625.374289,15.36324,1464,2567
192.168.0.38,31936,168.126.63.2,53,UDP,2,308,604,1,80,1,228,625.438171,0.006598,96999,276447
192.168.0.38,54824,211.249.219.23,443,TCP,95,53200,157,40,4371,55,48829,625.445006,180.191884,194,2167
192.168.0.38,18595,168.126.63.2,53,UDP,2,285,605,1,79,1,206,625.489854,0.004065,,
192.168.0.38,37548,168.126.63.2,53,UDP,2,261,606,1,79,1,182,625.489928,0.003991,,
192.168.0.38,54825,121.53.218.25,443,TCP,35,8140,158,17,2303,18,5837,625.494146,180.029334,102,259
192.168.0.38,54826,211.56.99.89,443,TCP,241,293047,159,40,3896,201,289151,625.535224,15.061324,2069,153585
192.168.0.38,54827,211.249.222.33,443,TCP,18,4765,160,10,2436,8,2329,625.558258,55.630647,350,334
192.168.0.38,22052,168.126.63.2,53,UDP,2,294,607,1,91,1,203,625.591375,0.004549,,
192.168.0.38,21028,168.126.63.2,53,UDP,2,242,608,1,91,1,151,625.591417,0.004508,,
192.168.0.38,31042,168.126.63.2,53,UDP,2,223,609,1,82,1,141,625.647888,0.005465,120036,206404
192.168.0.38,2769,168.126.63.2,53,UDP,2,274,610,1,82,1,192,625.647985,0.005369,122182,286086
192.168.0.38,54828,121.53.105.132,443,TCP,39,11771,161,18,4252,21,7519,625.653603,180.033264,188,334
192.168.0.38,44415,168.126.63.2,53,UDP,2,180,611,1,74,1,106,625.72473,0.005314,111403,159578
192.168.0.38,34593,168.126.63.2,53,UDP,2,205,612,1,74,1,131,625.724767,0.005276,112206,198635
192.168.0.38,54829,121.53.85.24,443,TCP,34,12749,162,15,2263,19,10486,625.730445,15.103645,1198,5554
192.168.0.38,50541,239.255.255.250,1900,UDP,4,872,613,4,872,0,0,633.151506,3.020368,2309,0
192.168.0.38,63702,172.217.161.238,443,UDP,19,6874,614,9,2460,10,4414,646.512009,0.268318,73345,131605
192.168.0.38,54119,142.250.206.206,443,UDP,20,9265,615,10,4138,10,5127,652.622134,0.324301,102078,126475
192.168.0.38,63001,66.22.228.211,50001,UDP,17920,20467363,616,17177,20382323,743,85040,653.459159,59.96526,2719217,11345
192.168.0.38,59282,142.250.76.131,443,UDP,26,7949,617,12,2861,14,5088,670.353586,0.189989,120470,214243
192.168.0.38,7152,168.126.63.2,53,UDP,2,208,618,1,79,1,129,684.219716,0.006131,103082,168324
192.168.0.38,6012,168.126.63.2,53,UDP,2,232,619,1,79,1,153,684.219756,0.006091,103759,200952
192.168.0.38,55638,142.250.206.206,443,UDP,20,9426,620,10,4135,10,5291,684.226278,0.341988,96728,123770
192.168.0.38,22360,168.126.63.2,53,UDP,2,198,621,1,91,1,107,687.876944,0.005922,122931,144545
192.168.0.38,29100,168.126.63.2,53,UDP,2,242,622,1,91,1,151,687.877024,0.005841,124636,206813
192.168.0.38,53901,142.250.206.202,443,UDP,19,6894,623,9,2464,10,4430,687.883773,0.265121,74350,133674
192.168.0.36,62761,192.168.0.38,7000,TCP,12,2613,163,6,449,6,2164,701.645856,0.03573,100531,484522
192.168.0.38,62929,168.126.63.2,53,UDP,2,182,624,1,83,1,99,704.442284,0.006728,98692,117717
192.168.0.38,49417,168.126.63.2,53,UDP,2,226,625,1,83,1,143,704.442379,0.006634,100090,172444
192.168.0.38,51194,142.250.206.238,443,UDP,17,6760,626,7,2346,10,4414,704.449796,0.263022,71355,134254
192.168.0.38,60744,168.126.63.1,53,UDP,2,244,627,1,84,1,160,706.47708,0.004397,,
192.168.0.38,65195,168.126.63.1,53,UDP,2,296,628,1,84,1,212,706.477205,0.004273,,
192.168.0.38,54201,17.248.221.12,443,TCP,54,23969,164,21,5360,33,18609,706.487372,31.63318,1355,4706
192.168.0.38,59468,168.126.63.1,53,UDP,2,227,629,1,76,1,151,708.066116,0.00548,110948,220437
192.168.0.38,57275,168.126.63.1,53,UDP,2,280,630,1,76,1,204,708.066229,0.005365,113327,304193
192.168.0.38,54202,17.248.221.69,443,TCP,30,9666,165,12,2947,18,6719,708.074806,30.476793,773,1763
192.168.0.38,49239,66.22.228.211,50001,UDP,17806,20355766,631,17068,20271184,738,84582,713.458061,60.005194,2702590,11276
192.168.0.38,63708,142.250.206.206,443,UDP,20,9425,632,10,4136,10,5289,714.597837,0.324648,101919,130331
192.168.0.3,49540,192.168.0.38,7000,TCP,13,2678,166,6,449,7,2229,717.457264,0.04142,86721,430516
192.168.0.88,57963,192.168.0.38,7000,TCP,14,2745,167,7,515,7,2230,718.247272,0.109304,37693,163214
192.168.0.36,62763,192.168.0.38,7000,TCP,13,2679,168,6,449,7,2230,718.248873,0.029059,123610,613923
192.168.0.23,51333,192.168.0.38,7000,TCP,12,2613,169,6,449,6,2164,718.254226,0.062865,57138,275383
192.168.0.50,52312,192.168.0.38,7000,TCP,12,2613,170,6,449,6,2164,718.813551,0.027024,132918,640615
192.168.0.54,60974,192.168.0.38,7000,TCP,12,2613,171,6,449,6,2164,719.725369,0.034373,104500,503651
192.168.0.35,49178,192.168.0.38,7000,TCP,12,2613,172,6,449,6,2164,723.009002,0.026794,134059,646114
192.168.0.47,55293,192.168.0.38,7000,TCP,12,2613,173,6,449,6,2164,724.091268,0.032193,111577,537756
192.168.0.63,50260,192.168.0.38,7000,TCP,12,2613,174,6,449,6,2164,729.147906,0.038445,93432,450305
192.168.0.3,49541,192.168.0.38,7000,TCP,12,2612,175,6,449,6,2163,729.240796,0.034685,103560,498890
192.168.0.50,52313,192.168.0.38,7000,TCP,12,2613,176,6,449,6,2164,730.476474,0.025193,142579,687175
192.168.0.36,62765,192.168.0.38,7000,TCP,12,2613,177,6,449,6,2164,730.662341,0.029106,123410,594791
192.168.0.88,57966,192.168.0.38,7000,TCP,13,2679,178,7,515,6,2164,730.879926,0.025866,159282,669295
192.168.0.47,55294,192.168.0.38,7000,TCP,12,2613,179,6,449,6,2164,731.235783,0.026356,136287,656852
192.168.0.43,49205,192.168.0.38,7000,TCP,14,4205,180,7,527,7,3678,732.1771,0.068783,61294,427780
192.168.0.23,51334,192.168.0.38,7000,TCP,14,4205,181,7,527,7,3678,734.265502,0.092408,45623,318413
192.168.0.35,49179,192.168.0.38,7000,TCP,12,2613,182,6,449,6,2164,735.37622,0.042504,84509,407302
192.168.0.38,57708,168.126.63.1,53,UDP,2,222,633,1,71,1,151,737.976169,0.00551,103085,219237
192.168.0.38,54945,162.159.137.232,443,UDP,18,6340,634,10,4087,8,2253,737.996454,0.246002,132909,73267
192.168.0.54,60976,192.168.0.38,7000,TCP,15,4271,183,7,527,8,3744,740.369549,0.059024,71428,507454
192.168.0.38,61433,168.126.63.1,53,UDP,2,338,635,1,74,1,264,741.055253,0.004583,,
192.168.0.38,50285,168.126.63.1,53,UDP,2,305,636,1,74,1,231,741.055507,0.005076,116627,364066
192.168.0.38,52479,168.126.63.1,53,UDP,2,230,637,1,78,1,152,741.060783,0.004969,,
192.168.0.38,54203,17.253.115.201,443,TCP,30,11261,184,13,1752,17,9509,741.06867,1.974522,7098,38526
192.168.0.38,54204,17.248.221.9,443,TCP,42,16042,185,16,4069,26,11973,742.270382,31.005034,1049,3089
192.168.0.96,54661,192.168.0.38,7000,TCP,12,2613,186,6,449,6,2164,743.798573,0.064723,55498,267478
192.168.0.38,55710,168.126.63.2,53,UDP,2,208,638,1,79,1,129,745.987994,0.005911,106919,174589
192.168.0.38,42057,168.126.63.2,53,UDP,2,242,639,1,79,1,163,745.988118,0.005788,109191,225293
192.168.0.38,57612,142.250.206.206,443,UDP,22,9606,640,11,4212,11,5394,745.994484,0.403991,83407,106814
192.168.0.38,58914,168.126.63.2,53,UDP,2,198,641,1,91,1,107,748.970367,0.005991,121515,142880
192.168.0.38,36111,168.126.63.2,53,UDP,2,232,642,1,91,1,141,748.970445,0.005914,123097,190733
192.168.0.38,64956,172.217.161.202,443,UDP,19,6894,643,9,2464,10,4430,748.977337,0.266226,74042,133119
192.168.0.38,58172,239.255.255.250,1900,UDP,4,872,644,4,872,0,0,753.157426,3.014541,2314,0
192.168.0.38,7106,168.126.63.2,53,UDP,2,258,645,1,85,1,173,754.590848,0.008091,84043,171054
192.168.0.38,63881,168.126.63.2,53,UDP,2,254,646,1,85,1,169,754.590944,0.007994,85063,169126
192.168.0.38,55961,216.239.34.180,443,UDP,27,15815,647,14,6676,13,9139,754.59988,0.347729,153590,210255
192.168.0.42,59905,192.168.0.38,7000,TCP,13,2679,187,6,449,7,2230,763.627149,0.067018,53597,266197
192.168.0.38,58156,168.126.63.2,53,UDP,2,437,648,1,83,1,354,767.34877,0.005237,126790,540767
192.168.0.38,44536,168.126.63.2,53,UDP,2,226,649,1,83,1,143,767.348838,0.005169,128458,221319
192.168.0.38,53988,142.250.206.206,443,UDP,19,6876,650,9,2461,10,4415,767.3549,0.291467,67547,121180
192.168.0.38,32803,168.126.63.2,53,UDP,2,162,651,1,73,1,89,773.439175,0.003981,,
192.168.0.38,8785,168.126.63.2,53,UDP,2,206,652,1,73,1,133,773.439214,0.003943,,
192.168.0.38,51578,142.250.206.225,443,UDP,27,11879,653,13,3168,14,8711,773.443859,0.284247,89161,245167
192.168.0.38,55119,66.22.228.211,50001,UDP,17679,20080368,654,16935,19995762,744,84606,773.457691,59.971211,2667381,11286
192.168.0.38,60052,142.250.206.206,443,UDP,20,9401,655,10,4136,10,5265,776.721193,0.34452,96040,122257
192.168.0.38,54816,168.126.63.2,53,UDP,2,421,656,1,75,1,346,792.002558,0.005975,100418,463263
192.168.0.38,27821,168.126.63.2,53,UDP,2,207,657,1,75,1,132,792.002594,0.00594,101010,177777
192.168.0.38,63691,142.250.206.195,443,UDP,29,8159,658,13,2940,16,5219,792.009206,0.183503,128172,227527
192.168.0.59,52374,192.168.0.38,7000,TCP,13,2679,188,6,449,7,2230,802.324507,0.047686,75326,374113
192.168.0.38,56284,142.250.206.206,443,UDP,20,9465,659,10,4135,10,5330,809.280518,0.325935,101492,130823
192.168.0.38,60968,142.250.206.206,443,UDP,27,7695,660,13,2967,14,4728,810.906026,9.406264,2523,4021
192.168.0.38,6653,168.126.63.2,53,UDP,2,198,661,1,91,1,107,810.915879,0.004978,,
192.168.0.38,40135,168.126.63.2,53,UDP,2,242,662,1,91,1,151,810.915951,0.004906,,
192.168.0.38,51485,142.250.207.106,443,UDP,19,6895,663,9,2465,10,4430,810.921481,0.265687,74222,133390
192.168.0.88,57978,192.168.0.38,7000,TCP,15,4271,189,8,593,7,3678,813.37912,0.074635,63562,394238
192.168.0.38,63847,66.22.228.211,50001,UDP,17695,20178550,664,16946,20093466,749,85084,833.456967,60.043428,2677191,11336
192.168.0.38,54279,168.126.63.1,53,UDP,2,296,665,1,84,1,212,834.451379,0.004645,,
192.168.0.38,54205,17.248.221.5,443,TCP,36,13589,190,13,3291,23,10298,834.460211,30.580209,860,2694
192.168.0.47,55304,192.168.0.38,7000,TCP,12,2613,191,6,449,6,2164,837.278595,0.180733,19874,95787
192.168.0.38,62336,142.250.206.206,443,UDP,70,22875,666,35,11422,35,11453,840.360772,33.007087,2768,2775
192.168.0.7,51892,192.168.0.38,7000,TCP,13,2678,192,6,449,7,2229,843.137768,0.046061,77983,387138
192.168.0.59,52384,192.168.0.38,7000,TCP,13,2679,193,6,449,7,2230,843.618746,0.031376,114482,568587
192.168.0.38,46028,168.126.63.2,53,UDP,2,166,667,1,75,1,91,859.084377,0.006454,92965,112798
192.168.0.38,45603,168.126.63.2,53,UDP,2,210,668,1,75,1,135,859.084419,0.006411,93589,168460
192.168.0.38,61568,142.250.76.131,443,UDP,18,7121,669,8,2393,10,4728,859.091618,0.143383,133516,263796
192.168.0.38,13634,168.126.63.2,53,UDP,2,210,670,1,73,1,137,859.115244,0.005137,113685,213354
192.168.0.38,23399,168.126.63.2,53,UDP,2,254,671,1,73,1,181,859.115277,0.005103,114442,283754
192.168.0.38,50283,142.250.206.225,443,UDP,15,6882,672,7,2636,8,4246,859.120878,0.144448,145990,235157
192.168.0.38,29261,168.126.63.2,53,UDP,2,166,673,1,75,1,91,859.253887,0.004248,,
192.168.0.38,13549,168.126.63.2,53,UDP,2,200,674,1,75,1,125,859.25395,0.004185,,
192.168.0.38,63913,142.250.206.206,443,UDP,19,6888,675,9,2411,10,4477,859.292414,0.258827,74520,138378
192.168.0.38,64792,168.126.63.1,53,UDP,2,344,676,1,75,1,269,865.131425,0.004965,,
192.168.0.38,62274,168.126.63.1,53,UDP,2,284,677,1,75,1,209,865.13275,0.004941,,
192.168.0.38,54727,168.126.63.1,53,UDP,2,288,678,1,106,1,182,865.137354,0.004399,,
192.168.0.38,53661,168.126.63.1,53,UDP,2,228,679,1,106,1,122,865.141597,0.005682,149243,171770
192.168.0.38,54206,52.232.209.85,443,TCP,25,8708,194,12,2384,13,6324,865.161563,31.137073,612,1624
192.168.0.38,34746,168.126.63.2,53,UDP,2,182,680,1,83,1,99,866.819382,0.004738,,
192.168.0.38,61209,168.126.63.2,53,UDP,2,226,681,1,83,1,143,866.819436,0.005761,115257,198576
192.168.0.38,57650,142.250.76.142,443,UDP,19,6873,682,9,2459,10,4414,866.825558,0.254981,77150,138488
192.168.0.38,41866,168.126.63.2,53,UDP,2,198,683,1,91,1,107,873.113886,0.005771,126147,148327
192.168.0.38,51778,168.126.63.2,53,UDP,2,242,684,1,91,1,151,873.113936,0.005722,127228,211114
192.168.0.38,50820,172.217.25.170,443,UDP,19,6895,685,9,2465,10,4430,873.12009,0.265359,74314,133554
192.168.0.38,55728,239.255.255.250,1900,UDP,4,872,686,4,872,0,0,873.161713,3.023198,2307,0
192.168.0.47,55307,192.168.0.38,7000,TCP,12,2613,195,6,449,6,2164,875.559223,0.040266,89206,429940
192.168.0.38,59105,168.126.63.1,53,UDP,2,244,687,1,84,1,160,879.01443,0.004816,,
192.168.0.38,55701,168.126.63.1,53,UDP,4,551,688,2,169,2,382,879.014555,919.481454,1,3
192.168.0.38,54207,17.248.221.4,443,TCP,39,19743,196,17,5386,22,14357,879.022804,2.718739,15848,42246
192.168.0.38,52102,168.126.63.1,53,UDP,2,327,689,1,114,1,213,879.758114,0.005648,161473,301699
192.168.0.38,60015,168.126.63.1,53,UDP,2,258,690,1,114,1,144,879.758249,0.005512,165457,208998
192.168.0.38,51294,168.126.63.1,53,UDP,2,287,691,1,101,1,186,879.764929,0.005991,134868,248372
192.168.0.38,54208,52.219.129.14,443,TCP,60,30355,197,29,22296,31,8059,879.772735,3.346602,53298,19264
192.168.0.38,54209,17.248.221.4,443,TCP,37,15866,198,15,6742,22,9124,880.697855,30.77193,1752,2372
192.168.0.38,54210,17.248.221.4,443,TCP,67,31513,199,28,9780,39,21733,881.555325,4.830267,16197,35994
192.168.0.38,54211,52.219.129.14,443,TCP,36,10175,200,16,2710,20,7465,882.159001,1.926436,11253,31000
192.168.0.38,54212,17.248.221.4,443,TCP,36,13048,201,16,4054,20,8994,882.520145,30.54476,1061,2355
192.168.0.42,59907,192.168.0.38,7000,TCP,12,2613,202,6,449,6,2164,891.694831,0.054493,65916,317692
192.168.0.38,53578,66.22.228.211,50001,UDP,17845,20352179,692,17095,20266945,750,85234,893.456533,60.008193,2701890,11362
192.168.0.38,30135,168.126.63.2,53,UDP,2,198,693,1,79,1,119,908.379359,0.014426,43809,65991
192.168.0.38,20678,168.126.63.2,53,UDP,2,242,694,1,79,1,163,908.379403,0.005139,122981,253745
192.168.0.38,57562,172.217.25.174,443,UDP,20,9444,695,10,4136,10,5308,908.395269,0.329186,100514,128996
192.168.0.38,61015,142.250.76.131,443,UDP,29,8160,696,13,2941,16,5219,912.737895,0.256726,91646,162632
192.168.0.7,51897,192.168.0.38,7000,TCP,12,2612,203,6,449,6,2163,914.503774,0.052957,67828,326755
192.168.0.38,63802,142.250.76.142,443,UDP,35,8549,697,17,3497,18,5052,914.533774,1.282283,21817,31518
192.168.0.38,55497,168.126.63.1,53,UDP,4,572,698,2,158,2,414,917.470891,4099.271887,0,0
192.168.0.38,63374,168.126.63.1,53,UDP,2,207,699,1,76,1,131,917.470995,0.004529,,
192.168.0.38,52122,168.126.63.1,53,UDP,2,237,700,1,85,1,152,917.476175,0.005116,132916,237685
192.168.0.38,54213,211.249.201.68,443,TCP,29,12473,204,15,2790,14,9683,917.484535,61.618898,362,1257
192.168.0.38,38989,168.126.63.2,53,UDP,2,198,701,1,91,1,107,933.979205,0.006021,120910,142169
192.168.0.38,18460,168.126.63.2,53,UDP,2,242,702,1,91,1,151,933.979331,0.005896,123473,204884
192.168.0.38,64809,142.250.206.202,443,UDP,17,6775,703,7,2345,10,4430,933.986087,0.268935,69756,131779
192.168.0.29,5353,224.0.0.251,5353,UDP,20,6451,704,20,6451,0,0,935.027206,2245.633102,22,0
fe80::8c7:93f0:19cb:e926,5353,ff02::fb,5353,UDP,20,6851,705,20,6851,0,0,935.027207,2245.633103,24,0
192.168.0.38,61538,172.217.25.174,443,UDP,20,9428,706,10,4138,10,5290,939.832144,0.347014,95396,121954
192.168.0.38,21926,168.126.63.2,53,UDP,2,162,707,1,73,1,89,953.090487,0.008813,66265,80789
192.168.0.38,23092,168.126.63.2,53,UDP,2,206,708,1,73,1,133,953.090555,0.006416,91022,165835
192.168.0.38,54744,142.250.206.225,443,UDP,25,12322,709,11,3060,14,9262,953.099758,0.190509,128497,388937
192.168.0.38,59202,66.22.228.211,50001,UDP,17810,20334309,710,17064,20249351,746,84958,953.455471,60.004927,2699691,11326
192.168.0.96,54665,192.168.0.38,7000,TCP,13,2679,205,6,449,7,2230,954.541491,0.040032,89728,445643
192.168.0.38,5353,192.168.0.29,5353,UDP,7,8190,711,7,8190,0,0,968.250455,2176.560997,30,0
192.168.0.38,21039,168.126.63.2,53,UDP,2,208,712,1,79,1,129,973.858036,0.00585,108034,176410
192.168.0.38,5994,168.126.63.2,53,UDP,2,242,713,1,79,1,163,973.85808,0.005805,108871,224633
192.168.0.38,58003,142.250.76.142,443,UDP,20,9357,714,10,4134,10,5223,973.864674,0.339128,97520,123210
192.168.0.38,54466,168.126.63.2,53,UDP,2,182,715,1,83,1,99,975.723922,0.005876,113002,134785
192.168.0.38,34969,168.126.63.2,53,UDP,2,226,716,1,83,1,143,975.724003,0.005796,114561,197377
192.168.0.38,64503,142.250.207.110,443,UDP,19,6875,717,9,2461,10,4414,975.730308,0.258312,76217,136702
192.168.0.28,60315,192.168.0.38,7000,TCP,13,2679,206,6,449,7,2230,988.581682,0.043602,82381,409155
192.168.0.38,60663,142.250.206.225,443,UDP,33,14913,718,16,3656,17,11257,991.866833,3.785269,7726,23791
192.168.0.38,57733,239.255.255.250,1900,UDP,4,872,719,4,872,0,0,993.168242,3.022027,2308,0
192.168.0.38,24257,168.126.63.2,53,UDP,2,198,720,1,91,1,107,994.653717,0.008989,80987,95227
192.168.0.38,24320,168.126.63.2,53,UDP,2,242,721,1,91,1,151,994.653882,0.008824,82502,136899
192.168.0.38,53121,142.250.206.202,443,UDP,18,6855,722,8,2425,10,4430,994.663391,0.270067,71834,131226
192.168.0.7,51902,192.168.0.38,7000,TCP,12,2612,207,6,449,6,2163,995.089726,0.055336,64912,312707
192.168.0.59,52388,192.168.0.38,7000,TCP,13,2679,208,6,449,7,2230,1003.415819,0.04937,72756,361353
192.168.0.38,65133,142.250.76.142,443,UDP,20,9399,723,10,4135,10,5264,1004.595324,0.335885,98486,125376
169.254.105.78,5353,224.0.0.251,5353,UDP,1,171,724,1,171,0,0,1006.810975,0,,
fe80::ad:259d:559:114f,5353,ff02::fb,5353,UDP,2,637,725,2,637,0,0,1006.810976,2.35459,2164,0
192.168.0.28,60318,192.168.0.38,7000,TCP,12,2613,209,6,449,6,2164,1009.254664,0.048938,73398,353753
fe80::102a:21ec:c118:a887,5353,fe80::1005:4a67:dd2e:c718,5353,UDP,1,459,726,1,459,0,0,1010.232424,0,,
192.168.0.51,52157,192.168.0.38,7000,TCP,12,2613,210,6,449,6,2164,1013.072861,0.070883,50675,244233
192.168.0.38,65194,66.22.228.211,50001,UDP,17792,20305604,727,17043,20220292,749,85312,1013.455566,60.044612,2694035,11366
192.168.0.38,57330,142.250.207.110,443,UDP,19,6875,728,9,2461,10,4414,1022.67704,0.258506,76160,136600
192.168.0.38,5353,192.168.0.42,5353,UDP,14,13329,729,12,12685,2,644,1023.702633,3202.468638,31,1
192.168.0.38,45558,168.126.63.2,53,UDP,2,405,730,1,75,1,330,1034.37367,0.006194,96867,426218
192.168.0.38,19870,168.126.63.2,53,UDP,2,207,731,1,75,1,132,1034.373746,0.006119,98055,172577
192.168.0.38,56343,142.250.76.131,443,UDP,28,8087,732,12,2867,16,5220,1034.38049,0.162079,141511,257652
192.168.0.38,20450,168.126.63.2,53,UDP,2,208,733,1,79,1,129,1035.579494,0.00625,101120,165120
192.168.0.38,37535,168.126.63.2,53,UDP,2,242,734,1,79,1,163,1035.579538,0.006207,101820,210085
192.168.0.47,55318,192.168.0.38,7000,TCP,13,2679,211,7,515,6,2164,1049.234668,0.056988,72295,303783
192.168.0.38,30007,168.126.63.2,53,UDP,2,446,735,1,91,1,355,1056.473241,0.004608,,
192.168.0.38,56057,168.126.63.2,53,UDP,2,242,736,1,91,1,151,1056.473338,0.00451,,
192.168.0.38,61303,142.250.207.106,443,UDP,19,6893,737,9,2463,10,4430,1056.478675,0.257558,76503,137600
192.168.0.38,55542,168.126.63.1,53,UDP,2,296,738,1,84,1,212,1066.820285,0.005348,125654,317127
192.168.0.38,54214,17.248.221.2,443,TCP,39,20545,212,16,5322,23,15223,1066.829812,2.670823,15941,45597
192.168.0.38,64019,168.126.63.2,53,UDP,2,164,739,1,74,1,90,1066.868815,0.007368,80347,97719
192.168.0.38,61697,142.250.206.196,443,UDP,2735,2186719,740,661,106548,2074,2080171,1066.876885,80.158783,10633,207605
192.168.0.38,62583,168.126.63.1,53,UDP,2,327,741,1,114,1,213,1067.85561,0.00446,,
192.168.0.38,54215,52.219.128.206,443,TCP,132,102960,213,78,93659,54,9301,1067.861958,3.085698,242820,24113
192.168.0.38,41832,168.126.63.2,53,UDP,2,188,742,1,86,1,102,1068.040393,0.00603,114096,135323
192.168.0.38,60815,168.126.63.2,53,UDP,2,232,743,1,86,1,146,1068.040582,0.00584,117808,200000
192.168.0.38,56912,172.217.25.174,443,UDP,273,138735,744,112,12920,161,125815,1068.047655,46.309053,2231,21734
192.168.0.38,54216,17.248.221.2,443,TCP,38,16958,214,15,7546,23,9412,1068.734056,30.65944,1968,2455
192.168.0.38,54217,17.248.221.2,443,TCP,64,30435,215,28,9771,36,20664,1069.446965,3.905054,20017,42332
192.168.0.38,37225,168.126.63.2,53,UDP,2,185,745,1,74,1,111,1071.239634,0.00575,102956,154434
192.168.0.38,30474,168.126.63.2,53,UDP,2,229,746,1,74,1,155,1071.239675,0.004609,,
192.168.0.38,21856,168.126.63.2,53,UDP,2,166,747,1,75,1,91,1071.461271,0.005172,116009,140757
192.168.0.38,35046,168.126.63.2,53,UDP,2,210,748,1,75,1,135,1071.461335,0.005108,117462,211433
192.168.0.38,62517,142.250.76.131,443,UDP,28,7982,749,14,2891,14,5091,1071.462088,56.486581,409,721
192.168.0.38,60119,172.217.161.195,443,UDP,12,5621,750,6,1758,6,3863,1071.467238,0.137677,102152,224467
192.168.0.7,51922,192.168.0.38,7000,TCP,12,2612,216,6,449,6,2163,1071.725332,0.047656,75373,363102
192.168.0.38,56453,66.22.228.211,50001,UDP,17750,20254757,751,17010,20170447,740,84310,1073.454059,59.96188,2691102,11248
192.168.0.38,11098,168.126.63.2,53,UDP,2,182,752,1,83,1,99,1075.899866,0.004439,,
192.168.0.38,42744,168.126.63.2,53,UDP,2,223,753,1,83,1,140,1075.89995,0.004354,,
192.168.0.38,55033,142.250.76.142,443,UDP,20,6953,754,10,2538,10,4415,1075.905074,0.282045,71988,125228
192.168.0.38,59864,168.126.63.1,53,UDP,2,190,755,1,87,1,103,1078.892532,0.003922,,
192.168.0.38,37354,168.126.63.1,53,UDP,2,234,756,1,87,1,147,1078.89258,0.003875,,
192.168.0.38,61124,142.250.206.202,443,UDP,18,7202,757,8,2694,10,4508,1078.896918,0.149186,144463,241738
192.168.0.42,59910,192.168.0.38,7000,TCP,12,2613,217,6,449,6,2164,1080.853527,0.035293,101776,490522
192.168.0.38,22454,168.126.63.2,53,UDP,2,236,758,1,85,1,151,1081.910196,0.004983,,
192.168.0.38,15445,168.126.63.2,53,UDP,2,256,759,1,85,1,171,1081.910257,0.003466,,
192.168.0.38,61002,142.250.76.129,443,UDP,20,11154,760,9,2540,11,8614,1081.915639,0.145144,139998,474783
192.168.0.38,51101,168.126.63.2,53,UDP,2,258,761,1,85,1,173,1087.809597,0.007407,91805,186850
192.168.0.38,27555,168.126.63.2,53,UDP,4,452,762,2,176,2,276,1087.809659,963.182636,1,2
192.168.0.38,49653,216.239.38.180,443,UDP,20,8437,763,10,3587,10,4850,1087.818074,0.273202,105035,142019
192.168.0.38,55548,168.126.63.2,53,UDP,2,208,764,1,79,1,129,1088.862346,0.006199,101951,166478
192.168.0.38,62817,168.126.63.2,53,UDP,2,242,765,1,79,1,163,1088.862404,0.006141,102914,212343
192.168.0.38,50539,142.250.207.110,443,UDP,22,9871,766,10,4603,12,5268,1088.869104,0.322422,114210,130710
192.168.0.96,54667,192.168.0.38,7000,TCP,12,2613,218,6,449,6,2164,1097.60743,0.087791,40915,197195
192.168.0.38,30109,168.126.63.2,53,UDP,2,166,767,1,75,1,91,1099.290341,0.005042,119000,144387
192.168.0.38,13829,168.126.63.2,53,UDP,2,200,768,1,75,1,125,1099.290372,0.005011,119736,199560
192.168.0.38,64461,142.250.76.142,443,UDP,146,39711,769,67,14716,79,24995,1099.295806,16.911052,6961,11824
192.168.0.38,62177,168.126.63.1,53,UDP,2,256,770,1,77,1,179,1105.673312,0.005283,116600,271058
192.168.0.38,57958,168.126.63.1,53,UDP,2,227,771,1,77,1,150,1105.673419,0.007968,77309,150602
192.168.0.38,50620,168.126.63.1,53,UDP,2,235,772,1,87,1,148,1105.679554,0.005146,135250,230081
192.168.0.38,54218,210.89.168.35,443,TCP,23,7630,219,13,1859,10,5771,1105.698119,31.179442,476,1480
192.168.0.38,52242,168.126.63.1,53,UDP,2,257,773,1,77,1,180,1105.727353,0.004929,,
192.168.0.38,53386,168.126.63.1,53,UDP,2,202,774,1,77,1,125,1105.727538,0.003687,,
192.168.0.38,50070,168.126.63.1,53,UDP,2,227,775,1,78,1,149,1105.732829,0.006573,94933,181347
192.168.0.38,54219,117.18.237.29,80,TCP,10,1825,220,6,755,4,1070,1105.741334,31.018286,194,275
192.168.0.38,49510,142.250.76.142,443,UDP,27,7698,776,13,2970,14,4728,1109.607849,15.59287,1523,2425
192.168.0.38,51374,239.255.255.250,1900,UDP,4,872,777,4,872,0,0,1113.168759,3.019378,2310,0
192.168.0.38,63526,172.217.161.195,443,UDP,26,16312,778,14,6634,12,9678,1114.413652,0.129867,408664,596179
192.168.0.38,30025,168.126.63.2,53,UDP,2,162,779,1,73,1,89,1116.285058,0.005998,97365,118706
192.168.0.38,49412,168.126.63.2,53,UDP,2,206,780,1,73,1,133,1116.285104,0.005951,98134,178793
192.168.0.38,54936,142.250.207.97,443,UDP,23,11362,781,10,2981,13,8381,1116.291668,0.192085,124153,349053
192.168.0.38,52592,168.126.63.2,53,UDP,2,198,782,1,91,1,107,1117.463505,0.004906,,
192.168.0.38,29316,168.126.63.2,53,UDP,2,242,783,1,91,1,151,1117.463546,0.004864,,
192.168.0.38,64662,142.250.206.234,443,UDP,19,6896,784,9,2466,10,4430,1117.468854,0.265923,74186,133271
192.168.0.38,32096,168.126.63.2,53,UDP,2,166,785,1,75,1,91,1118.193512,0.004874,,
192.168.0.38,27099,168.126.63.2,53,UDP,2,210,786,1,75,1,135,1118.193558,0.004827,,
192.168.0.38,63723,142.250.207.110,443,UDP,22,10182,787,10,5003,12,5179,1122.037601,0.303525,131863,136502
192.168.0.23,51344,192.168.0.38,7000,TCP,12,2613,221,6,449,6,2164,1122.201153,0.050061,71752,345818
192.168.0.38,54139,66.22.228.211,50001,UDP,17705,20212258,788,16964,20127866,741,84392,1133.45342,60.004207,2683527,11251
192.168.0.38,27976,168.126.63.2,53,UDP,2,238,789,1,71,1,167,1146.470261,0.00389,,
192.168.0.38,47121,168.126.63.2,53,UDP,2,202,790,1,71,1,131,1146.470314,0.003837,,
192.168.0.38,51315,172.217.25.182,443,UDP,21,12906,791,9,2551,12,10355,1146.475373,0.14407,141653,574998
192.168.0.38,28330,168.126.63.2,53,UDP,2,274,792,1,81,1,193,1147.348789,0.006341,102192,243494
192.168.0.38,46623,168.126.63.2,53,UDP,2,222,793,1,81,1,141,1147.348827,0.006302,102824,178990
192.168.0.38,50928,142.250.206.234,443,UDP,64,43725,794,25,4896,39,38829,1147.355702,0.387051,101195,802560
192.168.0.38,29228,168.126.63.2,53,UDP,2,166,795,1,75,1,91,1150.736516,0.004681,,
192.168.0.38,30987,168.126.63.2,53,UDP,2,210,796,1,75,1,135,1150.736592,0.004606,,
192.168.0.38,62234,142.250.206.195,443,UDP,12,5623,797,6,1760,6,3863,1150.741795,0.132962,105894,232427
192.168.0.7,51926,192.168.0.38,7000,TCP,12,2612,222,6,449,6,2163,1155.365464,0.06166,58254,280635
192.168.0.38,62532,142.250.207.110,443,UDP,22,9878,798,10,4675,12,5203,1156.767283,0.301125,124200,138228
192.168.0.38,56261,142.250.207.99,443,UDP,27,8020,799,12,2867,15,5153,1158.013316,0.188402,121739,218808
192.168.0.38,63946,168.126.63.1,53,UDP,2,296,800,1,84,1,212,1171.875403,0.005109,131532,331963
192.168.0.38,54220,17.248.221.14,443,TCP,40,20856,223,18,5507,22,15349,1171.884569,2.179546,20213,56338
192.168.0.38,63060,168.126.63.1,53,UDP,2,327,801,1,114,1,213,1172.573957,0.005818,156754,292884
192.168.0.38,58786,168.126.63.1,53,UDP,2,258,802,1,114,1,144,1172.574069,0.005707,159803,201857
192.168.0.38,54221,52.219.164.30,443,TCP,151,112840,224,84,102837,67,10003,1172.58204,2.753709,298759,29060
192.168.0.38,54222,17.248.221.14,443,TCP,38,17117,225,15,7703,23,9414,1174.160892,31.014223,1986,2428
192.168.0.38,54223,17.248.221.13,443,TCP,35,14535,226,14,3682,21,10853,1175.232008,1.889707,15587,45945
192.168.0.38,54224,52.219.164.30,443,TCP,38,10283,227,18,2818,20,7465,1175.835718,2.361045,9548,25293
192.168.0.38,54225,17.248.221.14,443,TCP,37,13124,228,15,3998,22,9126,1176.235923,30.849224,1036,2366
192.168.0.38,54226,17.248.221.13,443,TCP,54,26978,229,23,8424,31,18554,1177.065928,4.178657,16127,35521
192.168.0.38,32069,168.126.63.2,53,UDP,2,446,803,1,91,1,355,1178.405579,0.005246,138772,541364
192.168.0.38,40578,168.126.63.2,53,UDP,2,242,804,1,91,1,151,1178.405671,0.005153,141276,234426
192.168.0.38,57450,142.250.207.106,443,UDP,19,6894,805,9,2464,10,4430,1178.411606,0.262188,75182,135170
192.168.0.54,61024,192.168.0.38,7000,TCP,12,2613,230,6,449,6,2164,1179.130659,0.088139,40753,196417
192.168.0.38,64233,168.126.63.2,53,UDP,2,182,806,1,83,1,99,1183.052121,0.0054,122962,146666
192.168.0.38,60393,168.126.63.2,53,UDP,2,226,807,1,83,1,143,1183.052178,0.005344,124251,214071
192.168.0.38,64799,172.217.161.238,443,UDP,19,6874,808,9,2460,10,4414,1183.058207,0.272633,72184,129522
192.168.0.38,33210,168.126.63.1,53,UDP,2,190,809,1,87,1,103,1186.927675,0.005276,131918,156178
192.168.0.38,41710,168.126.63.1,53,UDP,2,234,810,1,87,1,147,1186.927742,0.00521,133589,225719
192.168.0.38,52675,142.250.206.202,443,UDP,18,7207,811,8,2699,10,4508,1186.933689,0.147234,146650,244943
192.168.0.38,53528,66.22.228.211,50001,UDP,17783,20292101,812,17040,20207377,743,84724,1193.452219,60.001951,2694229,11296
192.168.0.38,47641,168.126.63.2,53,UDP,2,194,813,1,89,1,105,1213.057783,0.005285,134720,158940
192.168.0.38,14116,168.126.63.2,53,UDP,2,238,814,1,89,1,149,1213.057825,0.005244,135774,227307
192.168.0.38,53716,172.217.161.234,443,UDP,21,8967,815,10,3843,11,5124,1213.063477,0.413584,74335,99114
192.168.0.7,51928,192.168.0.38,7000,TCP,12,2612,231,6,449,6,2163,1228.694557,0.069633,51584,248502
192.168.0.38,54202,172.217.161.238,443,UDP,19,6872,816,9,2458,10,4414,1230.307613,0.272508,72159,129581
192.168.0.38,53156,239.255.255.250,1900,UDP,4,872,817,4,872,0,0,1233.171043,3.014916,2313,0
192.168.0.38,9224,168.126.63.2,53,UDP,2,446,818,1,91,1,355,1239.416631,0.005484,132749,517870
192.168.0.38,59447,168.126.63.2,53,UDP,2,242,819,1,91,1,151,1239.416676,0.00544,133823,222058
192.168.0.38,51541,172.217.161.202,443,UDP,19,6896,820,9,2466,10,4430,1239.422494,0.253843,77717,139613
192.168.0.38,50939,168.126.63.1,53,UDP,2,252,821,1,96,1,156,1249.984921,0.005958,128902,209466
192.168.0.38,64451,168.126.63.1,53,UDP,2,208,822,1,96,1,112,1249.985082,0.005797,132482,154562
192.168.0.38,59969,142.250.76.129,443,UDP,35,16455,823,18,5276,17,11179,1250.007845,0.847055,49829,105579
192.168.0.38,54323,142.250.76.129,443,UDP,32,16227,824,16,5117,16,11110,1250.861382,1.197964,34171,74192
192.168.0.38,60931,168.126.63.1,53,UDP,2,216,825,1,78,1,138,1251.500894,0.00532,117293,207518
192.168.0.38,57391,168.126.63.1,53,UDP,2,268,826,1,78,1,190,1251.501019,0.005196,120092,292532
192.168.0.38,54227,142.250.207.106,443,TCP,28,10153,232,12,1993,16,8160,1251.510686,120.856955,131,540
192.168.0.38,55498,142.250.76.129,443,UDP,33,16369,827,17,5187,16,11182,1252.083567,0.625922,66295,142918
192.168.0.38,65519,142.250.76.129,443,UDP,33,17424,828,17,5383,16,12041,1252.770702,0.619201,69547,155568
192.168.0.38,57829,142.250.76.129,443,UDP,35,17832,829,18,5644,17,12188,1253.395302,0.650992,69358,149777
192.168.0.38,58736,66.22.228.211,50001,UDP,17921,20464995,830,17175,20380009,746,84986,1253.450775,59.968649,2718755,11337
192.168.0.38,55823,142.250.76.129,443,UDP,35,17804,831,18,5642,17,12162,1254.021969,0.650661,69369,149534
192.168.0.38,54228,142.250.76.129,443,TCP,3,206,233,2,132,1,74,1254.129141,0.041586,25393,14235
192.168.0.38,65451,142.250.76.129,443,UDP,42,29025,832,18,7555,24,21470,1254.664263,0.734596,82276,233815
192.168.0.38,54229,142.250.76.129,443,TCP,3,206,234,2,132,1,74,1254.780822,0.036095,29256,16401
192.168.0.38,51490,168.126.63.1,53,UDP,2,270,833,1,78,1,192,1258.49084,0.004796,,
192.168.0.38,49627,168.126.63.1,53,UDP,2,322,834,1,78,1,244,1258.490919,0.004718,,
192.168.0.38,54230,17.248.221.7,443,TCP,38,20614,235,16,5369,22,15245,1258.501323,2.111037,20346,57772
192.168.0.38,65011,168.126.63.1,53,UDP,2,327,835,1,114,1,213,1259.185762,0.005073,179775,335895
192.168.0.38,65076,168.126.63.1,53,UDP,2,258,836,1,114,1,144,1259.185825,0.005009,182072,229986
192.168.0.38,54231,52.219.132.174,443,TCP,129,97631,236,73,88222,56,9409,1259.193106,3.662879,192683,20549
192.168.0.38,54232,17.248.221.7,443,TCP,38,17062,237,16,7705,22,9357,1260.686253,30.669822,2009,2440
192.168.0.38,54233,17.248.221.6,443,TCP,64,30467,238,27,9708,37,20759,1261.427629,5.036955,15418,32970
192.168.0.23,51346,192.168.0.38,7000,TCP,12,2613,239,6,449,6,2164,1277.139086,0.067228,53430,257511
192.168.0.38,41572,168.126.63.2,53,UDP,2,421,837,1,75,1,346,1278.687892,0.00464,,
192.168.0.38,58344,168.126.63.2,53,UDP,2,207,838,1,75,1,132,1278.687953,0.004579,,
192.168.0.38,63241,142.250.206.195,443,UDP,30,8288,839,14,3016,16,5272,1278.693294,0.46961,51378,89810
192.168.0.38,52456,168.126.63.2,53,UDP,2,182,840,1,83,1,99,1281.205809,0.006011,110464,131758
192.168.0.38,23024,168.126.63.2,53,UDP,2,223,841,1,83,1,140,1281.205841,0.021426,30990,52272
192.168.0.38,61206,172.217.161.238,443,UDP,19,6879,842,9,2465,10,4414,1281.224729,0.267962,73592,131779
192.168.0.38,31226,168.126.63.2,53,UDP,2,446,843,1,91,1,355,1301.05662,0.005741,126807,494687
192.168.0.38,48342,168.126.63.2,53,UDP,2,242,844,1,91,1,151,1301.056927,0.005434,133971,222304
192.168.0.38,62115,142.250.207.106,443,UDP,19,6894,845,9,2464,10,4430,1301.063325,0.262332,75141,135095
192.168.0.38,61168,66.22.228.211,50001,UDP,17796,20296470,846,17046,20211124,750,85346,1313.450236,60.049059,2692614,11370
192.168.0.38,43752,168.126.63.2,53,UDP,2,164,847,1,74,1,90,1321.162024,0.005737,103189,125501
192.168.0.38,34225,168.126.63.2,53,UDP,2,421,848,1,74,1,347,1321.16209,0.005671,104390,489508
192.168.0.38,53796,172.217.25.164,443,UDP,748,548668,849,200,37931,548,510737,1321.168589,19.099937,15887,213921
192.168.0.38,22004,168.126.63.2,53,UDP,2,188,850,1,86,1,102,1323.195592,0.005004,137490,163069
192.168.0.38,1599,168.126.63.2,53,UDP,2,229,851,1,86,1,143,1323.195659,0.004938,,
192.168.0.38,56174,142.250.76.142,443,UDP,141,62472,852,61,7687,80,54785,1323.201183,16.781,3664,26117
192.168.0.38,55742,172.217.161.238,443,UDP,19,6876,853,9,2461,10,4415,1330.512453,0.296192,66470,119246
192.168.0.38,12907,168.126.63.2,53,UDP,2,238,854,1,71,1,167,1339.430344,0.005376,105654,248511
192.168.0.38,28526,168.126.63.2,53,UDP,2,202,855,1,71,1,131,1339.430388,0.005331,106546,196586
192.168.0.38,61410,142.250.207.118,443,UDP,21,9922,856,9,2551,12,7371,1339.436113,0.148479,137447,397147
192.168.0.38,44961,168.126.63.2,53,UDP,2,274,857,1,81,1,193,1340.428035,0.006701,96701,230413
192.168.0.38,61605,168.126.63.2,53,UDP,2,222,858,1,81,1,141,1340.428062,0.006673,97107,169039
192.168.0.38,60933,172.217.25.170,443,UDP,66,43184,859,26,5212,40,37972,1340.435201,0.474321,87906,640443
192.168.0.38,21995,168.126.63.2,53,UDP,2,166,860,1,75,1,91,1343.685371,0.005767,104040,126235
192.168.0.38,34949,168.126.63.2,53,UDP,2,207,861,1,75,1,132,1343.68544,0.005699,105281,185295
192.168.0.38,48701,168.126.63.2,53,UDP,2,166,862,1,75,1,91,1343.685598,0.005541,108283,131384
192.168.0.38,53610,168.126.63.2,53,UDP,2,210,863,1,75,1,135,1343.685678,0.005461,109869,197765
192.168.0.38,52956,172.217.25.163,443,UDP,12,5621,864,6,1758,6,3863,1343.692501,0.138939,101224,222428
192.168.0.38,59802,168.126.63.2,53,UDP,2,208,865,1,79,1,129,1349.891172,0.005161,122456,199961
192.168.0.38,57168,142.250.76.142,443,UDP,23,10204,866,11,5126,12,5078,1349.897037,0.317335,129226,128016
192.168.0.7,51935,192.168.0.38,7000,TCP,12,2612,240,6,449,6,2163,1350.505311,0.037678,95334,459260
192.168.0.38,43309,168.126.63.2,53,UDP,2,162,867,1,73,1,89,1352.051743,0.004957,,
192.168.0.38,59523,168.126.63.2,53,UDP,2,206,868,1,73,1,133,1352.051777,0.004923,,
192.168.0.38,59714,142.250.76.129,443,UDP,21,11145,869,9,2906,12,8239,1352.057263,0.188895,123073,348934
192.168.0.38,55235,239.255.255.250,1900,UDP,4,872,870,4,872,0,0,1353.176871,3.022129,2308,0
192.168.0.38,41738,168.126.63.2,53,UDP,2,198,871,1,91,1,107,1363.133054,0.005342,136278,160239
192.168.0.38,54160,168.126.63.2,53,UDP,2,242,872,1,91,1,151,1363.133147,0.005251,138640,230051
192.168.0.38,61230,142.250.207.106,443,UDP,19,6896,873,9,2466,10,4430,1363.139333,0.251893,78318,140694
192.168.0.38,49518,66.22.228.211,50001,UDP,17835,20334936,874,17087,20249774,748,85162,1373.449461,60.049128,2697760,11345
192.168.0.38,41995,168.126.63.2,53,UDP,2,164,875,1,74,1,90,1386.975683,0.005156,114817,139643
192.168.0.38,3394,168.126.63.2,53,UDP,2,173,876,1,74,1,99,1386.975733,0.005106,115942,155111
192.168.0.38,54602,142.250.206.196,443,UDP,451,376524,877,123,20362,328,356162,1386.981475,2.170681,75043,1312627
192.168.0.38,10455,168.126.63.2,53,UDP,2,258,878,1,85,1,173,1387.550729,0.004844,,
192.168.0.38,42090,168.126.63.2,53,UDP,2,254,879,1,85,1,169,1387.550769,0.117186,5802,11537
192.168.0.38,52631,216.239.38.180,443,UDP,21,8495,880,10,3580,11,4915,1387.564489,0.283926,100871,138486
192.168.0.38,16520,168.126.63.1,53,UDP,2,190,881,1,87,1,103,1388.867103,0.0047,,
192.168.0.38,29570,168.126.63.1,53,UDP,2,234,882,1,87,1,147,1388.86723,0.004573,,
192.168.0.38,53900,172.217.25.170,443,UDP,26,8529,883,12,3601,14,4928,1388.872229,7.482568,3850,5268
192.168.0.38,63962,172.217.161.238,443,UDP,27,7696,884,13,2968,14,4728,1390.660007,21.175746,1121,1786
192.168.0.38,65306,172.217.25.163,443,UDP,38,9096,885,17,3380,21,5716,1392.605376,7.015245,3854,6518
192.168.0.38,46264,168.126.63.2,53,UDP,2,465,886,1,76,1,389,1395.087007,0.445072,1366,6992
192.168.0.38,51166,168.126.63.2,53,UDP,2,248,887,1,76,1,172,1395.087057,0.06825,8908,20161
192.168.0.38,9577,168.126.63.1,53,UDP,2,211,888,1,83,1,128,1395.087351,0.004321,,
192.168.0.38,15617,168.126.63.1,53,UDP,2,245,889,1,83,1,162,1395.087392,0.004279,,
192.168.0.38,55242,172.217.25.174,443,UDP,21,10218,890,10,5704,11,4514,1395.09217,0.234071,194949,154277
192.168.0.38,49867,168.126.63.2,53,UDP,2,168,891,1,76,1,92,1395.155641,0.074064,8209,9937
192.168.0.38,54830,34.64.212.68,443,TCP,22,7555,241,11,2098,11,5457,1395.23004,0.223735,75017,195123
192.168.0.38,54831,34.64.212.68,443,TCP,136,131515,242,37,5138,99,126377,1395.453102,155.663823,264,6494
192.168.0.38,56106,168.126.63.2,53,UDP,2,154,892,1,69,1,85,1395.730409,0.656146,841,1036
192.168.0.38,5079,168.126.63.2,53,UDP,2,203,893,1,69,1,134,1395.730447,0.004763,,
192.168.0.38,11020,168.126.63.2,53,UDP,2,170,894,1,77,1,93,1395.731685,0.006195,99435,120096
192.168.0.38,41962,168.126.63.2,53,UDP,2,214,895,1,77,1,137,1395.73176,0.006119,100670,179114
192.168.0.38,12110,168.126.63.2,53,UDP,2,176,896,1,80,1,96,1395.731895,0.005986,106916,128299
192.168.0.38,15571,168.126.63.2,53,UDP,2,220,897,1,80,1,140,1395.73194,0.00594,107744,188552
192.168.0.38,54832,34.64.212.68,443,TCP,112,109619,243,28,4355,84,105264,1395.733058,155.885134,223,5402
192.168.0.38,54833,34.64.212.68,443,TCP,56,39616,244,20,3196,36,36420,1395.733439,155.884754,164,1869
192.168.0.38,54834,34.64.212.68,443,TCP,65,48418,245,23,3383,42,45035,1395.733645,155.884548,173,2311
192.168.0.38,54835,34.64.212.68,443,TCP,94,94567,246,21,3259,73,91308,1395.733732,155.884461,167,4685
192.168.0.38,54836,34.64.212.68,443,TCP,26,8567,247,12,1974,14,6593,1395.734424,155.3825,101,339
192.168.0.38,59382,142.250.207.99,443,UDP,370,333000,898,102,12225,268,320775,1395.742338,0.707414,138250,3627578
192.168.0.38,38549,168.126.63.2,53,UDP,2,154,899,1,69,1,85,1395.799273,0.005399,102241,125949
192.168.0.38,54837,192.0.77.37,443,TCP,145,106799,248,64,5514,81,101285,1395.805072,75.499947,584,10732
192.168.0.38,12216,168.126.63.2,53,UDP,2,154,900,1,69,1,85,1395.86908,0.004557,,
192.168.0.38,56735,168.126.63.2,53,UDP,2,203,901,1,69,1,134,1395.869116,0.00452,,
192.168.0.38,57872,168.126.63.2,53,UDP,2,176,902,1,80,1,96,1395.869182,0.004454,,
192.168.0.38,11196,168.126.63.2,53,UDP,2,220,903,1,80,1,140,1395.869216,0.00442,,
192.168.0.38,55588,168.126.63.2,53,UDP,2,154,904,1,69,1,85,1395.86927,0.004366,,
192.168.0.38,30471,168.126.63.2,53,UDP,2,203,905,1,69,1,134,1395.869304,0.006998,78879,153186
192.168.0.38,49735,168.126.63.2,53,UDP,2,150,906,1,67,1,83,1395.874171,0.007034,76201,94398
192.168.0.38,58971,168.126.63.2,53,UDP,2,195,907,1,67,1,128,1395.874205,0.006999,76582,146306
192.168.0.38,3283,168.126.63.2,53,UDP,2,154,908,1,69,1,85,1396.177708,0.006789,81307,100162
192.168.0.38,9011,168.126.63.2,53,UDP,2,203,909,1,69,1,134,1396.177741,0.006757,81693,158650
192.168.0.38,54838,192.0.77.2,443,TCP,65,22093,249,30,3438,35,18655,1396.184972,91.168226,301,1636
192.168.0.38,19362,168.126.63.2,53,UDP,2,278,910,1,91,1,187,1396.279866,0.007438,97875,201129
192.168.0.38,58590,168.126.63.2,53,UDP,2,242,911,1,91,1,151,1396.279937,0.007366,98832,163996
192.168.0.38,2148,168.126.63.2,53,UDP,2,150,912,1,67,1,83,1396.284621,0.005039,106370,131772
192.168.0.38,25302,168.126.63.2,53,UDP,2,198,913,1,67,1,131,1396.284676,0.004983,,
192.168.0.38,62834,142.250.206.202,443,UDP,18,7097,914,8,2441,10,4656,1396.287839,0.14784,132088,251948
192.168.0.38,54839,192.0.77.48,443,TCP,32,10125,250,14,1934,18,8191,1396.290156,75.272441,205,870
192.168.0.38,65115,142.250.76.142,443,UDP,22,10663,915,10,5519,12,5144,1398.777937,0.29992,147212,137209
192.168.0.38,63459,168.126.63.1,53,UDP,2,249,916,1,76,1,173,1406.937442,0.004782,,
192.168.0.38,60058,168.126.63.1,53,UDP,2,207,917,1,76,1,131,1406.93756,0.004663,,
192.168.0.38,54857,168.126.63.1,53,UDP,2,237,918,1,85,1,152,1406.943077,0.00462,,
192.168.0.38,54234,211.249.219.27,443,TCP,27,14923,251,17,9697,10,5226,1406.952368,30.988607,2503,1349
192.168.0.7,51949,192.168.0.38,7000,TCP,12,2612,252,6,449,6,2163,1420.320488,0.070851,50697,244230
192.168.0.38,18622,168.126.63.2,53,UDP,2,446,919,1,91,1,355,1424.156115,0.00557,130700,509874
192.168.0.38,5622,168.126.63.2,53,UDP,2,242,920,1,91,1,151,1424.156159,0.005527,131717,218563
192.168.0.38,51755,172.217.25.170,443,UDP,19,6892,921,9,2462,10,4430,1424.162699,0.26643,73925,133018
192.168.0.38,56917,66.22.228.211,50001,UDP,17676,20175189,922,16928,20090263,748,84926,1433.447457,60.006294,2678420,11322
192.168.0.38,58749,168.126.63.2,53,UDP,4,394,923,3,295,1,99,1447.039986,5576.908265,0,0
192.168.0.38,24626,168.126.63.2,53,UDP,2,226,924,1,83,1,143,1447.040037,0.005871,113098,194856
192.168.0.38,62225,172.217.161.238,443,UDP,19,6876,925,9,2462,10,4414,1447.046329,0.27867,70678,126716
192.168.0.54,61066,192.168.0.38,7000,TCP,12,2613,253,6,449,6,2164,1462.611001,0.060855,59025,284479
192.168.0.23,51351,192.168.0.38,7000,TCP,12,2613,254,6,449,6,2164,1469.853686,0.059924,59942,288899
192.168.0.38,64242,239.255.255.250,1900,UDP,4,872,926,4,872,0,0,1473.177484,3.019331,2310,0
192.168.0.38,39709,168.126.63.2,53,UDP,2,198,927,1,91,1,107,1485.602286,0.005984,121657,143048
192.168.0.38,2928,168.126.63.2,53,UDP,2,232,928,1,91,1,141,1485.602335,0.005936,122641,190026
192.168.0.38,56248,172.217.161.202,443,UDP,19,6896,929,9,2466,10,4430,1485.608844,0.267033,73878,132717
192.168.0.38,63314,66.22.228.211,50001,UDP,17838,20367591,930,17090,20282369,748,85222,1493.44795,60.004038,2704133,11362
192.168.0.38,63573,172.217.161.238,443,UDP,17,6730,931,8,2383,9,4347,1493.705392,0.26118,72991,133149
192.168.0.38,5822,168.126.63.2,53,UDP,2,166,932,1,75,1,91,1520.408575,0.006422,93428,113360
192.168.0.38,48417,168.126.63.2,53,UDP,2,210,933,1,75,1,135,1520.408638,0.00636,94339,169811
192.168.0.38,54628,142.250.206.227,443,UDP,27,8027,934,13,2941,14,5086,1520.415664,0.151607,155190,268378
192.168.0.57,52794,192.168.0.38,7000,TCP,12,2613,255,6,449,6,2164,1528.445587,0.080055,44869,216251
192.168.0.7,51970,192.168.0.38,7000,TCP,12,2612,256,6,449,6,2163,1533.588734,0.110418,32530,156713
192.168.0.38,5353,192.168.0.35,5353,UDP,13,14903,935,13,14903,0,0,1538.646057,3486.951613,34,0
192.168.0.38,47580,168.126.63.2,53,UDP,2,182,936,1,83,1,99,1540.470336,0.005035,131876,157298
192.168.0.38,21985,168.126.63.2,53,UDP,2,226,937,1,83,1,143,1540.470442,0.004929,,
192.168.0.38,57174,172.217.161.238,443,UDP,19,6871,938,9,2457,10,4414,1540.475861,0.255329,76983,138299
192.168.0.38,37735,168.126.63.2,53,UDP,2,198,939,1,91,1,107,1547.45452,0.061346,11867,13953
192.168.0.38,57698,168.126.63.2,53,UDP,2,242,940,1,91,1,151,1547.454563,0.00477,,
192.168.0.38,60656,142.250.76.138,443,UDP,24,7256,941,12,2691,12,4565,1547.516964,0.854125,25204,42757
192.168.0.38,63592,66.22.228.211,50001,UDP,17814,20344177,942,17071,20259489,743,84688,1553.447059,60.001435,2701200,11291
192.168.0.38,61955,168.126.63.1,53,UDP,2,216,943,1,78,1,138,1560.586132,0.005419,115150,203727
192.168.0.38,58394,168.126.63.1,53,UDP,2,268,944,1,78,1,190,1560.586273,0.005278,118226,287987
192.168.0.38,57286,142.250.76.138,443,UDP,28,13093,945,15,5138,13,7955,1560.599227,0.36843,111565,172732
192.168.0.38,54235,142.250.76.138,443,TCP,3,206,257,2,132,1,74,1560.730558,0.036098,29253,16399
192.168.0.38,52473,142.250.76.138,443,UDP,30,14599,946,16,5703,14,8896,1560.975818,0.344037,132613,206861
192.168.0.38,53538,142.250.76.138,443,UDP,35,19012,947,17,6127,18,12885,1561.327306,0.380026,128980,271244
192.168.0.38,54515,172.217.161.234,443,UDP,29,13769,948,16,5550,13,8219,1561.729805,0.390266,113768,168479
192.168.0.38,57950,168.126.63.1,53,UDP,2,256,949,1,91,1,165,1562.580505,0.005231,139170,252341
192.168.0.38,60558,168.126.63.1,53,UDP,2,198,950,1,91,1,107,1562.580581,0.005156,141194,166020
192.168.0.38,54236,15.164.151.105,443,TCP,41,12804,258,20,5801,21,7003,1562.590954,66.470231,698,842
192.168.0.38,53338,168.126.63.1,53,UDP,2,237,951,1,85,1,152,1580.603757,0.005197,130844,233981
192.168.0.38,58576,168.126.63.1,53,UDP,2,186,952,1,85,1,101,1580.603906,0.005047,134733,160095
192.168.0.38,54237,211.249.219.27,443,TCP,32,14209,259,17,3368,15,10841,1580.611978,61.995106,434,1398
192.168.0.38,53080,172.217.161.238,443,UDP,19,6879,953,9,2465,10,4414,1592.179516,0.267101,73829,132204
192.168.0.38,57248,239.255.255.250,1900,UDP,4,872,954,4,872,0,0,1593.179645,3.022589,2307,0
192.168.0.38,14268,168.126.63.2,53,UDP,2,198,955,1,91,1,107,1609.188876,0.004448,,
192.168.0.38,64856,168.126.63.2,53,UDP,2,242,956,1,91,1,151,1609.188932,0.004391,,
192.168.0.38,62558,142.250.76.138,443,UDP,19,6892,957,9,2462,10,4430,1609.19387,0.26757,73610,132451
192.168.0.38,56579,66.22.228.211,50001,UDP,25754,29045312,958,17726,20275272,8028,8770040,1613.446395,60.013656,2702754,1169072
192.168.0.7,51978,192.168.0.38,7000,TCP,12,2612,260,6,449,6,2163,1631.060345,0.050271,71452,344214
192.168.0.38,49231,168.126.63.1,53,UDP,2,222,959,1,71,1,151,1637.533325,0.004545,,
192.168.0.38,59270,162.159.137.232,443,UDP,18,6221,960,9,3848,9,2373,1637.54745,0.237606,129559,79896
192.168.0.38,37587,168.126.63.2,53,UDP,2,421,961,1,75,1,346,1642.078555,0.00487,,
192.168.0.38,48252,168.126.63.2,53,UDP,2,210,962,1,75,1,135,1642.078638,0.004786,,
192.168.0.38,64384,142.250.76.131,443,UDP,29,8160,963,13,2941,16,5219,1642.084066,0.226075,104071,184682
192.168.0.38,36055,168.126.63.2,53,UDP,2,182,964,1,83,1,99,1652.334641,0.040769,16286,19426
192.168.0.38,16910,168.126.63.2,53,UDP,2,226,965,1,83,1,143,1652.33473,0.04068,16322,28121
192.168.0.38,59480,172.217.161.238,443,UDP,19,6876,966,9,2462,10,4414,1652.376946,0.298236,66041,118402
192.168.0.38,3952,168.126.63.2,53,UDP,2,446,967,1,91,1,355,1670.105467,0.005603,129930,506871
192.168.0.38,44430,168.126.63.2,53,UDP,2,242,968,1,91,1,151,1670.105547,0.005524,131788,218682
192.168.0.38,52515,172.217.25.170,443,UDP,27,8259,969,13,3123,14,5136,1670.111709,22.602762,1105,1817
192.168.0.38,56083,66.22.228.211,50001,UDP,34971,39795569,970,18139,20214016,16832,19581553,1673.444914,60.008134,2694836,2610519
192.168.0.38,50466,168.126.63.2,53,UDP,2,162,971,1,73,1,89,1673.468512,0.004465,,
192.168.0.38,29311,168.126.63.2,53,UDP,2,206,972,1,73,1,133,1673.468569,0.06488,9001,16399
192.168.0.38,65184,142.250.207.97,443,UDP,22,9840,973,10,2946,12,6894,1673.480077,0.230324,102325,239453
192.168.0.38,11673,168.126.63.1,53,UDP,2,190,974,1,87,1,103,1681.410373,0.004812,,
192.168.0.38,43105,168.126.63.1,53,UDP,2,234,975,1,87,1,147,1681.410408,0.004777,,
192.168.0.38,62985,142.250.207.106,443,UDP,17,9158,976,8,2851,9,6307,1681.415685,0.128786,177099,391781
192.168.0.38,3184,168.126.63.2,53,UDP,2,412,977,1,74,1,338,1682.951476,0.005116,115715,528537
192.168.0.38,3753,168.126.63.2,53,UDP,2,173,978,1,74,1,99,1682.951511,0.005081,116512,155874
192.168.0.38,54366,142.250.207.100,443,UDP,542,357727,979,162,32323,380,325404,1682.957088,5.307793,48717,490454
192.168.0.38,55619,168.126.63.2,53,UDP,2,506,980,1,85,1,421,1687.585524,0.004762,,
192.168.0.38,49527,168.126.63.2,53,UDP,2,254,981,1,85,1,169,1687.585552,0.117381,5793,11518
192.168.0.38,61034,216.239.36.180,443,UDP,27,15830,982,14,6679,13,9151,1687.596519,0.387407,137922,188969
192.168.0.38,20444,168.126.63.1,53,UDP,2,211,983,1,83,1,128,1691.657835,0.004176,,
192.168.0.38,7387,168.126.63.1,53,UDP,2,245,984,1,83,1,162,1691.658667,0.00582,114089,222680
192.168.0.38,38114,168.126.63.2,53,UDP,2,217,985,1,76,1,141,1691.660706,0.007046,86290,160090
192.168.0.38,39535,168.126.63.2,53,UDP,2,268,986,1,76,1,192,1691.66083,0.006923,87823,221869
192.168.0.38,57715,142.251.220.238,443,UDP,24,13929,987,12,6090,12,7839,1691.66532,0.499486,97540,125553
192.168.0.38,54840,211.249.222.33,443,TCP,64,45664,261,25,7982,39,37682,1691.668177,56.755882,1125,5311
192.168.0.38,62048,168.126.63.2,53,UDP,2,198,988,1,75,1,123,1692.053055,0.006179,97103,159249
192.168.0.38,61701,168.126.63.2,53,UDP,2,559,989,1,75,1,484,1692.053188,0.006047,99222,640317
192.168.0.38,56951,168.126.63.2,53,UDP,2,247,990,1,80,1,167,1692.053439,0.005796,110420,230503
192.168.0.38,17514,168.126.63.2,53,UDP,2,298,991,1,80,1,218,1692.053509,0.005727,111751,304522
192.168.0.38,35192,168.126.63.2,53,UDP,2,244,992,1,74,1,170,1692.054215,0.00502,117928,270916
192.168.0.38,30579,168.126.63.2,53,UDP,2,289,993,1,74,1,215,1692.054392,0.004844,,
192.168.0.38,54841,104.26.13.220,443,TCP,40,7693,262,21,2422,19,5271,1692.060987,397.013445,48,106
192.168.0.38,54842,211.56.99.88,443,TCP,218,243972,263,46,4730,172,239242,1692.061099,15.510152,2439,123398
192.168.0.38,54843,211.249.219.23,443,TCP,114,80577,264,39,4288,75,76289,1692.061172,180.263171,190,3385
192.168.0.38,40780,168.126.63.2,53,UDP,2,213,994,1,79,1,134,1692.136084,0.004458,,
192.168.0.38,14241,168.126.63.2,53,UDP,2,264,995,1,79,1,185,1692.136112,0.00443,,
192.168.0.38,54844,121.53.218.25,443,TCP,35,8137,265,17,2300,18,5837,1692.140731,180.029296,102,259
192.168.0.38,48076,168.126.63.2,53,UDP,2,622,996,1,76,1,546,1692.219043,0.00595,102184,734117
192.168.0.38,4906,168.126.63.2,53,UDP,2,344,997,1,76,1,268,1692.219086,0.005907,102928,362959
192.168.0.38,54845,23.67.53.136,443,TCP,748,899725,266,123,12998,625,886727,1692.22521,20.68719,5026,342908
192.168.0.38,19034,168.126.63.2,53,UDP,2,170,998,1,77,1,93,1692.258934,0.006201,99338,119980
192.168.0.38,23355,168.126.63.2,53,UDP,2,214,999,1,77,1,137,1692.258976,0.006158,100032,177979
192.168.0.38,55799,172.217.161.195,443,UDP,82,58825,1000,31,4355,51,54470,1692.265858,0.406824,85638,1071126
192.168.0.38,22695,168.126.63.2,53,UDP,2,208,1001,1,77,1,131,1692.271541,0.004732,,
192.168.0.38,16141,168.126.63.2,53,UDP,2,256,1002,1,77,1,179,1692.271616,0.004656,,
192.168.0.38,52102,168.126.63.2,53,UDP,2,253,1003,1,74,1,179,1692.274694,0.004769,,
192.168.0.38,40302,168.126.63.2,53,UDP,2,205,1004,1,74,1,131,1692.274948,0.004516,,
192.168.0.38,54846,27.0.236.25,443,TCP,94,97621,267,23,3529,71,94092,1692.276807,50.546416,558,14891
192.168.0.38,54847,27.0.236.25,443,TCP,97,109123,268,20,2672,77,106451,1692.276857,50.546366,422,16848
192.168.0.38,54848,27.0.236.25,443,TCP,51,39218,269,20,2647,31,36571,1692.276989,50.546234,418,5788
192.168.0.38,54849,27.0.236.25,443,TCP,57,49508,270,19,2581,38,46927,1692.277109,50.546113,408,7427
192.168.0.38,54850,27.0.236.25,443,TCP,201,240436,271,38,3988,163,236448,1692.277157,50.543991,631,37424
192.168.0.38,54851,27.0.236.25,443,TCP,27,14068,272,13,2185,14,11883,1692.277201,50.044039,349,1899
192.168.0.38,54852,211.231.100.117,443,TCP,107,76615,273,43,5934,64,70681,1692.279759,180.05779,263,3140
192.168.0.38,46048,168.126.63.2,53,UDP,2,192,1005,1,80,1,112,1692.279971,0.006045,105872,148221
192.168.0.38,25174,168.126.63.2,53,UDP,2,239,1006,1,80,1,159,1692.279973,0.010477,61086,121408
192.168.0.38,54853,211.249.222.33,443,TCP,21,8337,274,12,2649,9,5688,1692.287664,55.134309,384,825
192.168.0.38,60983,104.17.25.14,443,UDP,199,166337,1007,76,29063,123,137274,1692.290947,0.709464,327717,1547917
192.168.0.38,54854,211.56.99.88,443,TCP,1060,1506564,275,55,4921,1005,1501643,1692.4215,15.12649,2602,794179
192.168.0.38,51256,168.126.63.2,53,UDP,2,227,1008,1,81,1,146,1692.542651,0.012986,49899,89943
192.168.0.38,16420,168.126.63.2,53,UDP,2,278,1009,1,81,1,197,1692.542741,0.012897,50244,122198
192.168.0.38,10164,168.126.63.2,53,UDP,2,227,1010,1,81,1,146,1692.544334,0.011303,57329,103335
192.168.0.38,38075,168.126.63.2,53,UDP,2,278,1011,1,81,1,197,1692.54438,0.014121,45889,111606
192.168.0.38,54855,211.231.99.250,443,TCP,21,8045,276,12,2492,9,5553,1692.55591,55.367805,360,802
192.168.0.38,54856,211.231.99.250,443,TCP,19,7882,277,11,2426,8,5456,1692.558815,65.060604,298,670
192.168.0.38,63310,168.126.63.2,53,UDP,2,294,1012,1,91,1,203,1692.573621,0.007816,93142,207778
192.168.0.38,63169,168.126.63.2,53,UDP,2,242,1013,1,91,1,151,1692.573818,0.007619,95550,158550
192.168.0.38,62704,104.17.25.14,443,UDP,111,83256,1014,41,7790,70,75466,1693.15219,0.123486,504672,4889040
192.168.0.38,31224,168.126.63.2,53,UDP,2,292,1015,1,82,1,210,1693.20823,0.005162,127082,325455
192.168.0.38,44408,168.126.63.2,53,UDP,2,274,1016,1,82,1,192,1693.208262,0.00513,127875,299415
192.168.0.38,54857,211.249.220.83,443,TCP,40,11905,278,18,4323,22,7582,1693.213726,180.033065,192,336
192.168.0.54,61120,192.168.0.38,7000,TCP,12,2613,279,6,449,6,2164,1696.720944,0.099838,35978,173400
192.168.0.38,63380,168.126.63.2,53,UDP,2,208,1017,1,79,1,129,1697.915297,0.005577,113322,185045
192.168.0.38,6497,168.126.63.2,53,UDP,2,232,1018,1,79,1,153,1697.915364,0.00551,114700,222141
192.168.0.38,64384,172.217.25.174,443,UDP,22,10546,1019,10,5359,12,5187,1697.922103,0.316563,135429,131082
192.168.0.38,57596,172.217.161.238,443,UDP,27,7693,1020,13,2965,14,4728,1704.748562,0.69891,33938,54118
192.168.0.38,57689,239.255.255.250,1900,UDP,4,872,1021,4,872,0,0,1713.181952,3.017905,2311,0
192.168.0.47,55335,192.168.0.38,7000,TCP,13,2679,280,6,449,7,2230,1715.551568,0.076465,46975,233309
192.168.0.38,36334,168.126.63.2,53,UDP,2,446,1022,1,91,1,355,1731.634306,0.004791,,
192.168.0.38,12134,168.126.63.2,53,UDP,2,242,1023,1,91,1,151,1731.634361,0.004736,,
192.168.0.38,53288,172.217.25.170,443,UDP,19,6894,1024,9,2464,10,4430,1731.640013,0.265351,74286,133558
192.168.0.38,58340,168.126.63.2,53,UDP,2,176,1025,1,80,1,96,1732.167784,0.00484,,
192.168.0.38,29868,168.126.63.2,53,UDP,2,239,1026,1,80,1,159,1732.167816,0.004808,,
192.168.0.38,60944,35.190.80.1,443,UDP,25,8803,1027,13,3173,12,5630,1732.173042,0.405121,62657,111176
192.168.0.38,58456,66.22.228.211,50001,UDP,35016,39795017,1028,17664,19594926,17352,20200091,1733.4432,60.056687,2610190,2690803
192.168.0.38,52092,168.126.63.1,53,UDP,2,258,1029,1,89,1,169,1752.959432,0.004744,,
192.168.0.38,54858,162.159.134.234,443,TCP,1215,470768,281,595,43110,620,427658,1752.965091,1378.960542,250,2481
192.168.0.38,54780,168.126.63.1,53,UDP,2,344,1030,1,75,1,269,1755.679408,0.005323,112718,404283
192.168.0.38,64629,168.126.63.1,53,UDP,2,284,1031,1,75,1,209,1755.679499,0.005233,114656,319510
192.168.0.38,62998,168.126.63.1,53,UDP,2,288,1032,1,106,1,182,1755.685793,0.005171,163991,281570
192.168.0.38,54238,52.232.209.85,443,TCP,26,8774,282,12,2384,14,6390,1755.69539,31.163889,611,1640
192.168.0.38,41257,168.126.63.2,53,UDP,2,166,1033,1,75,1,91,1759.094298,0.004412,,
192.168.0.38,43128,168.126.63.2,53,UDP,2,210,1034,1,75,1,135,1759.094356,0.004355,,
192.168.0.38,55333,142.250.206.227,443,UDP,38,9093,1035,17,3353,21,5740,1759.099609,4.911353,5461,9349
192.168.0.7,51989,192.168.0.38,7000,TCP,12,2612,283,6,449,6,2163,1759.264006,0.070547,50916,245283
192.168.0.38,60287,168.126.63.2,53,UDP,2,182,1036,1,83,1,99,1765.288626,0.006052,109715,130865
192.168.0.38,13896,168.126.63.2,53,UDP,2,223,1037,1,83,1,140,1765.2887,0.005979,111055,187322
192.168.0.38,59493,142.250.206.238,443,UDP,21,7014,1038,10,2533,11,4481,1765.29545,0.401714,50443,89237
192.168.0.38,59442,142.250.207.100,443,UDP,20,9758,1039,9,4213,11,5545,1776.03894,0.16842,200118,263389
192.168.0.38,12976,168.126.63.2,53,UDP,2,208,1040,1,79,1,129,1787.009476,0.005651,111838,182622
192.168.0.38,7403,168.126.63.2,53,UDP,2,242,1041,1,79,1,163,1787.009514,0.005613,112595,232317
192.168.0.38,58649,172.217.161.206,443,UDP,22,10465,1042,10,5359,12,5106,1787.015687,0.323678,132452,126199
192.168.0.38,26698,168.126.63.2,53,UDP,2,198,1043,1,91,1,107,1792.686341,0.004631,,
192.168.0.38,11017,168.126.63.2,53,UDP,2,242,1044,1,91,1,151,1792.686501,0.004471,,
192.168.0.38,51503,142.250.206.234,443,UDP,35,8596,1045,17,3497,18,5099,1792.691442,11.627617,2405,3508
192.168.0.38,53856,66.22.228.211,50001,UDP,35318,40184118,1046,18192,20231919,17126,19952199,1793.442866,60.014363,2696943,2659656
192.168.0.23,51353,192.168.0.38,7000,TCP,12,2613,284,6,449,6,2164,1796.080561,0.053142,67592,325768
192.168.0.63,50262,192.168.0.38,7000,TCP,12,2613,285,6,449,6,2164,1796.082112,0.04331,82936,399722
192.168.0.38,52201,168.126.63.1,53,UDP,2,241,1047,1,78,1,163,1796.164632,0.003796,,
192.168.0.38,57801,168.126.63.1,53,UDP,2,284,1048,1,78,1,206,1796.164933,0.005455,114390,302108
192.168.0.38,55256,168.126.63.1,53,UDP,2,236,1049,1,78,1,158,1796.165131,0.005256,118721,240487
192.168.0.38,50722,17.248.161.70,443,UDP,30,9833,1050,16,5909,14,3924,1796.19557,60.16914,785,521
192.168.0.38,61547,139.178.159.31,443,UDP,267,41328,1051,134,18839,133,22489,1796.195615,1028.920928,146,174
192.168.0.38,53117,168.126.63.1,53,UDP,2,174,1052,1,79,1,95,1796.26816,0.004311,,
192.168.0.38,63179,168.126.63.1,53,UDP,2,164,1053,1,74,1,90,1796.278263,0.005031,117670,143112
192.168.0.50,52424,192.168.0.38,7000,TCP,12,2613,286,6,449,6,2164,1796.312484,0.02369,151625,730772
192.168.0.38,54524,168.126.63.1,53,UDP,2,196,1054,1,82,1,114,1796.321455,0.006071,108054,150222
192.168.0.38,60003,139.178.159.19,443,UDP,266,41240,1055,133,18760,133,22480,1796.498021,1028.617176,145,174
192.168.0.3,49543,192.168.0.38,7000,TCP,13,2678,287,6,449,7,2229,1796.514385,0.086256,41643,206733
192.168.0.38,61945,168.126.63.1,53,UDP,2,186,1056,1,85,1,101,1797.19411,0.003485,,
192.168.0.38,50994,168.126.63.1,53,UDP,2,281,1057,1,84,1,197,1797.195145,0.003684,,
192.168.0.38,54239,104.91.76.24,443,TCP,35,19036,288,14,2124,21,16912,1797.197987,0.432936,39248,312508
192.168.0.38,54240,17.36.202.253,443,TCP,28,15898,289,12,1993,16,13905,1797.200495,1.030089,15478,107990
192.168.0.38,64634,168.126.63.1,53,UDP,2,328,1058,1,90,1,238,1797.244352,0.040461,17794,47057
192.168.0.38,51967,168.126.63.1,53,UDP,2,302,1059,1,90,1,212,1797.244438,0.038553,18675,43991
192.168.0.38,62070,168.126.63.1,53,UDP,2,244,1060,1,84,1,160,1797.27045,0.005192,129429,246533
192.168.0.38,58949,168.126.63.1,53,UDP,2,296,1061,1,84,1,212,1797.270652,0.004991,,
192.168.0.38,52029,106.247.248.106,123,UDP,2,180,1062,1,90,1,90,1797.276477,0.005524,130340,130340
192.168.0.38,54241,17.248.221.9,443,TCP,316,181049,290,147,86174,169,94875,1797.280898,48.669101,14164,15595
192.168.0.38,64005,168.126.63.1,53,UDP,2,314,1063,1,120,1,194,1797.285463,0.004663,,
192.168.0.38,54242,108.128.72.146,443,TCP,29,15710,291,10,1602,19,14108,1797.294693,61.485577,208,1835
192.168.0.38,56682,3.36.253.109,123,UDP,2,180,1064,1,90,1,90,1797.315239,0.023308,30890,30890
192.168.0.38,58970,168.126.63.1,53,UDP,2,241,1065,1,78,1,163,1797.843661,0.004458,,
192.168.0.38,58839,168.126.63.1,53,UDP,2,284,1066,1,78,1,206,1797.843839,0.004279,,
192.168.0.38,61101,168.126.63.1,53,UDP,2,324,1067,1,82,1,242,1797.847231,0.004362,,
192.168.0.38,54244,23.201.36.118,443,TCP,35,13177,292,16,2439,19,10738,1797.853332,0.106272,183604,808340
192.168.0.38,54243,44.232.250.207,443,TCP,796,749366,293,551,724453,245,24913,1797.8581,185.460199,31249,1074
192.168.0.88,58119,192.168.0.38,7000,TCP,13,2679,294,7,515,6,2164,1797.992121,0.051687,79710,334939
192.168.0.38,54780,106.247.248.106,123,UDP,2,180,1068,1,90,1,90,1798.218557,0.008028,89686,89686
192.168.0.38,59639,3.36.253.109,123,UDP,2,180,1069,1,90,1,90,1798.243092,0.012519,57512,57512
192.168.0.38,51043,168.126.63.1,53,UDP,2,275,1070,1,82,1,193,1798.484851,0.004759,,
192.168.0.38,65154,168.126.63.1,53,UDP,2,254,1071,1,82,1,172,1798.485013,0.004598,,
192.168.0.38,54245,99.86.207.74,443,TCP,32,11393,295,14,3648,18,7745,1798.505075,120.765289,241,513
192.168.0.38,57706,168.126.63.1,53,UDP,2,336,1072,1,79,1,257,1798.655667,0.00741,85290,277462
192.168.0.38,52913,168.126.63.1,53,UDP,2,281,1073,1,79,1,202,1798.655749,0.003798,,
192.168.0.38,62640,168.126.63.1,53,UDP,2,361,1074,1,137,1,224,1798.663472,0.005108,214565,350822
192.168.0.38,54246,3.224.52.11,443,TCP,32,9447,296,14,2552,18,6895,1798.670508,62.138473,328,887
192.168.0.38,58575,106.247.248.106,123,UDP,2,180,1075,1,90,1,90,1798.795485,0.007439,96787,96787
192.168.0.38,63596,3.36.253.109,123,UDP,2,180,1076,1,90,1,90,1798.795561,0.015493,46472,46472
192.168.0.38,63539,106.247.248.106,123,UDP,2,180,1077,1,90,1,90,1798.837262,0.006586,109322,109322
192.168.0.38,49981,3.36.253.109,123,UDP,2,180,1078,1,90,1,90,1798.837375,0.013454,53515,53515
192.168.0.38,53160,168.126.63.1,53,UDP,2,250,1079,1,95,1,155,1798.957412,0.004438,,
192.168.0.38,51847,168.126.63.1,53,UDP,2,286,1080,1,95,1,191,1798.957505,0.004346,,
192.168.0.38,62918,172.217.161.234,443,UDP,31,14973,1081,16,6093,15,8880,1798.971662,120.288249,405,590
192.168.0.38,58278,168.126.63.1,53,UDP,2,344,1082,1,104,1,240,1800.789144,0.004541,,
192.168.0.38,57912,168.126.63.1,53,UDP,2,284,1083,1,104,1,180,1800.78925,0.004435,,
192.168.0.38,52238,168.126.63.1,53,UDP,2,288,1084,1,106,1,182,1800.794231,0.005039,168287,288946
192.168.0.38,55579,168.126.63.1,53,UDP,2,228,1085,1,106,1,122,1800.794312,0.006547,129524,149075
192.168.0.38,54247,40.70.161.102,443,TCP,65,26575,297,34,17478,31,9097,1800.803026,93.21512,1500,780
192.168.0.38,62760,168.126.63.1,53,UDP,2,298,1086,1,85,1,213,1802.446113,0.00414,,
192.168.0.38,51252,168.126.63.1,53,UDP,2,236,1087,1,78,1,158,1802.44618,0.004074,,
192.168.0.38,54248,17.248.221.6,443,TCP,50,23728,298,23,10303,27,13425,1802.448828,30.897269,2667,3476
192.168.0.38,49721,168.126.63.1,53,UDP,2,288,1088,1,106,1,182,1803.108909,0.00501,169261,290618
192.168.0.38,54249,52.177.138.113,443,TCP,25,8969,299,12,2636,13,6333,1803.115898,59.91683,351,845
192.168.0.7,51990,192.168.0.38,7000,TCP,12,2612,300,6,449,6,2163,1804.445986,0.044665,80420,387417
192.168.0.38,58638,168.126.63.1,53,UDP,2,227,1089,1,76,1,151,1805.592022,0.005459,111375,221285
192.168.0.38,51739,168.126.63.1,53,UDP,2,280,1090,1,76,1,204,1805.592107,0.005374,113137,303684
192.168.0.38,54250,17.248.221.73,443,TCP,29,8682,301,12,2256,17,6426,1805.599299,30.413524,593,1690
192.168.0.43,49209,192.168.0.38,7000,TCP,12,2613,302,6,449,6,2164,1808.365781,0.039791,90271,435073
192.168.0.38,60261,168.126.63.1,53,UDP,2,342,1091,1,82,1,260,1809.784945,0.005006,131042,415501
192.168.0.38,63828,168.126.63.1,53,UDP,2,287,1092,1,82,1,205,1809.784999,0.004953,,
192.168.0.38,60436,168.126.63.1,53,UDP,2,361,1093,1,137,1,224,1809.790573,0.00545,201100,328807
192.168.0.38,54251,3.224.33.168,443,TCP,38,11368,303,18,4094,20,7274,1809.79744,49.296092,664,1180
192.168.0.38,49457,168.126.63.1,53,UDP,2,218,1094,1,79,1,139,1810.697453,0.005617,112515,197970
192.168.0.38,55007,142.250.207.110,443,UDP,35,20650,1095,16,5030,19,15620,1810.705282,0.544697,73875,229411
192.168.0.38,58169,142.250.206.238,443,UDP,18,8029,1096,9,3676,9,4353,1810.895633,0.264439,111209,131690
192.168.0.38,54252,142.250.207.110,443,TCP,13,6011,304,6,901,7,5110,1811.026077,0.116839,61691,349883
192.168.0.96,54672,192.168.0.38,7000,TCP,15,4271,305,7,527,8,3744,1811.577713,0.051808,81377,578134
192.168.0.38,52960,142.250.207.110,443,UDP,32,19777,1097,21,12131,11,7646,1812.121682,0.167786,578403,364559
192.168.0.38,56685,168.126.63.1,53,UDP,2,327,1098,1,114,1,213,1812.309129,0.005409,168607,315030
192.168.0.38,51144,168.126.63.1,53,UDP,2,258,1099,1,114,1,144,1812.309192,0.005088,179245,226415
192.168.0.38,54253,52.219.36.74,443,TCP,40,13281,306,18,5708,22,7573,1812.315698,6.643326,6873,9119
192.168.0.38,56216,142.250.207.110,443,UDP,31,17610,1100,20,9969,11,7641,1812.34139,0.170197,468586,359160
192.168.0.38,61782,142.250.207.110,443,UDP,29,13811,1101,16,6034,13,7777,1812.525406,0.173418,278356,358763
192.168.0.38,64510,142.250.207.97,443,UDP,29,14480,1102,13,3208,16,11272,1821.474875,0.369338,69486,244155
192.168.0.54,61144,192.168.0.38,7000,TCP,12,2613,307,6,449,6,2164,1824.352033,0.810745,4430,21353
192.168.0.38,61940,168.126.63.1,53,UDP,2,246,1103,1,93,1,153,1826.402684,0.004393,,
192.168.0.38,63523,168.126.63.1,53,UDP,2,298,1104,1,93,1,205,1826.402805,0.004271,,
192.168.0.38,49842,172.217.25.170,443,UDP,31,13466,1105,16,5469,15,7997,1826.40946,0.211394,206968,302638
192.168.0.47,55344,192.168.0.38,7000,TCP,12,2613,308,6,449,6,2164,1832.348393,0.038818,92534,445978
192.168.0.47,55345,192.168.0.38,7000,TCP,14,4205,309,7,527,7,3678,1832.577942,0.032654,129111,901084
192.168.0.38,65051,239.255.255.250,1900,UDP,4,872,1106,4,872,0,0,1833.182907,3.014117,2314,0
192.168.0.38,61023,142.250.207.100,443,UDP,1252,881766,1107,340,64638,912,817128,1834.477015,31.678577,16323,206354
192.168.0.38,48325,168.126.63.2,53,UDP,2,188,1108,1,86,1,102,1835.21938,0.004487,,
192.168.0.38,24782,168.126.63.2,53,UDP,2,232,1109,1,86,1,146,1835.219415,0.005681,121105,205597
192.168.0.38,58790,142.250.206.206,443,UDP,15,6815,1110,7,2442,8,4373,1835.225666,0.17886,109225,195594
192.168.0.38,19986,168.126.63.1,53,UDP,2,190,1111,1,87,1,103,1840.745913,0.002725,,
192.168.0.38,41593,168.126.63.1,53,UDP,2,234,1112,1,87,1,147,1840.745964,0.002674,,
192.168.0.38,63007,142.250.76.138,443,UDP,26,8531,1113,12,3603,14,4928,1840.749116,18.875543,1527,2088
192.168.0.38,6042,168.126.63.2,53,UDP,2,421,1114,1,75,1,346,1844.330761,0.005579,107546,496146
192.168.0.38,3307,168.126.63.2,53,UDP,2,210,1115,1,75,1,135,1844.330885,0.005454,110011,198019
192.168.0.38,17921,168.126.63.2,53,UDP,2,166,1116,1,75,1,91,1844.331237,0.005104,117554,142633
192.168.0.38,27925,168.126.63.2,53,UDP,2,210,1117,1,75,1,135,1844.331358,0.004983,,
192.168.0.38,56528,142.250.207.99,443,UDP,12,5619,1118,6,1756,6,3863,1844.339319,0.144413,97276,213997
192.168.0.38,51302,172.217.25.163,443,UDP,12,5621,1119,6,1758,6,3863,1844.341299,0.127842,110010,241735
192.168.0.38,53860,168.126.63.2,53,UDP,2,208,1120,1,79,1,129,1850.534154,0.005137,123029,200895
192.168.0.38,11553,168.126.63.2,53,UDP,2,232,1121,1,79,1,153,1850.534183,0.005107,123751,239671
192.168.0.38,55848,142.250.207.110,443,UDP,62,21466,1122,30,13882,32,7584,1850.5397,65.849134,1686,921
192.168.0.38,51539,66.22.228.211,50001,UDP,35655,40577255,1123,18428,20521834,17227,20055421,1853.441868,59.978143,2737241,2675030
192.168.0.38,15835,168.126.63.2,53,UDP,2,182,1124,1,83,1,99,1865.44243,0.006852,96906,115586
192.168.0.38,5404,168.126.63.2,53,UDP,2,226,1125,1,83,1,143,1865.442632,0.006649,99864,172055
192.168.0.38,37256,168.126.63.2,53,UDP,2,446,1126,1,91,1,355,1865.534431,0.006005,121232,472939
192.168.0.38,47559,168.126.63.2,53,UDP,2,242,1127,1,91,1,151,1865.534481,0.005955,122250,202854
192.168.0.38,57674,142.250.206.202,443,UDP,43,9986,1128,21,3946,22,6040,1865.540934,21.469836,1470,2250
192.168.0.42,59913,192.168.0.38,7000,TCP,12,2613,310,6,449,6,2164,1878.128559,0.037063,96916,467096
192.168.0.38,14944,168.126.63.2,53,UDP,2,256,1129,1,79,1,177,1882.052858,0.161418,3915,8772
192.168.0.38,37631,168.126.63.2,53,UDP,2,318,1130,1,79,1,239,1882.054161,0.006537,96680,292488
192.168.0.38,42704,168.126.63.2,53,UDP,2,256,1131,1,79,1,177,1882.124355,0.083051,7609,17049
192.168.0.38,34696,168.126.63.1,53,UDP,2,256,1132,1,79,1,177,1882.196311,0.152635,4140,9277
192.168.0.38,54859,23.7.234.171,443,TCP,1144,1253029,311,312,48697,832,1204332,1882.207795,206.867883,1883,46573
192.168.0.38,54860,23.7.234.171,443,TCP,396,381127,312,142,14638,254,366489,1882.863719,1.852019,63230,1583089
192.168.0.38,54861,23.7.234.171,443,TCP,527,446187,313,226,45297,301,400890,1882.864479,52.426069,6912,61174
192.168.0.38,54862,23.7.234.171,443,TCP,633,592890,314,236,43375,397,549515,1882.864906,53.255839,6515,82547
192.168.0.38,54863,23.7.234.171,443,TCP,1555,1860766,315,322,37257,1233,1823509,1882.865666,2.991433,99636,4876616
192.168.0.38,54864,23.7.234.171,443,TCP,155,124042,316,69,9824,86,114218,1882.866524,1.112954,70615,821007
192.168.0.38,57809,168.126.63.2,53,UDP,2,216,1133,1,76,1,140,1882.866842,0.010178,59736,110041
192.168.0.38,25032,168.126.63.2,53,UDP,2,236,1134,1,76,1,160,1882.866875,0.010144,59936,126182
192.168.0.38,48710,168.126.63.2,53,UDP,2,234,1135,1,72,1,162,1882.867013,0.007614,75650,170212
192.168.0.38,48412,168.126.63.2,53,UDP,2,293,1136,1,72,1,221,1882.867048,0.140953,4086,12543
192.168.0.38,59547,168.126.63.2,53,UDP,2,535,1137,1,80,1,455,1882.86729,0.180775,3540,20135
192.168.0.38,64077,168.126.63.2,53,UDP,2,379,1138,1,80,1,299,1882.867426,0.247185,2589,9676
192.168.0.38,54865,13.225.114.104,443,TCP,76,55249,317,26,2783,50,52466,1882.879549,206.139793,108,2036
192.168.0.38,25077,168.126.63.2,53,UDP,2,192,1139,1,80,1,112,1882.880645,0.004285,,
192.168.0.38,3994,168.126.63.2,53,UDP,2,239,1140,1,80,1,159,1882.880716,0.016271,39333,78175
192.168.0.38,21786,168.126.63.2,53,UDP,2,206,1141,1,78,1,128,1882.881658,0.004797,,
192.168.0.38,53143,168.126.63.2,53,UDP,2,230,1142,1,78,1,152,1882.88169,0.004765,,
192.168.0.38,54866,104.85.64.115,443,TCP,35,10898,318,16,3867,19,7031,1882.88224,206.293091,149,272
192.168.0.38,54867,104.85.64.115,443,TCP,36,10242,319,17,3927,19,6315,1882.882344,206.299169,152,244
192.168.0.38,54868,104.85.64.115,443,TCP,33,10000,320,16,2715,17,7285,1882.882462,206.238536,105,282
192.168.0.38,54869,104.85.64.115,443,TCP,42,17817,321,19,3967,23,13850,1882.88266,206.236979,153,537
192.168.0.38,54870,104.85.64.115,443,TCP,32,8603,322,15,2649,17,5954,1882.882941,206.292354,102,230
192.168.0.38,54871,104.85.64.115,443,TCP,39,11690,323,19,5097,20,6593,1882.883011,206.237943,197,255
192.168.0.38,56804,142.250.206.228,443,UDP,39,17906,1143,19,5022,20,12884,1882.887531,2.776045,14472,37129
192.168.0.38,62845,104.17.25.14,443,UDP,23,10956,1144,11,2602,12,8354,1882.893747,0.053682,387764,1244961
192.168.0.38,55603,168.126.63.2,53,UDP,2,330,1145,1,80,1,250,1882.942175,0.004894,,
192.168.0.38,17929,168.126.63.1,53,UDP,2,391,1146,1,80,1,311,1882.942294,0.236049,2711,10540
192.168.0.38,54872,142.250.206.228,443,TCP,20,9789,324,10,1251,10,8538,1882.956485,66.838116,149,1021
192.168.0.38,11046,168.126.63.2,53,UDP,2,391,1147,1,80,1,311,1882.962733,0.246375,2597,10098
192.168.0.38,54873,104.45.152.60,443,TCP,26,7657,325,14,2142,12,5515,1882.966117,206.239929,83,213
192.168.0.38,54874,104.45.152.60,443,TCP,25,7576,326,13,2071,12,5505,1882.96618,206.239866,80,213
192.168.0.38,54875,104.45.152.60,443,TCP,18,5575,327,10,1303,8,4272,1883.117642,66.835496,155,511
192.168.0.38,3037,168.126.63.2,53,UDP,2,338,1148,1,80,1,258,1883.564,0.006832,93676,302107
192.168.0.38,42202,168.126.63.2,53,UDP,2,399,1149,1,80,1,319,1883.564048,0.054695,11701,46658
192.168.0.38,54876,40.71.11.145,443,TCP,32,13954,328,15,2297,17,11657,1883.577824,205.617552,89,453
192.168.0.38,54877,40.71.11.145,443,TCP,32,16941,329,15,2302,17,14639,1883.577875,205.628171,89,569
192.168.0.38,17246,168.126.63.2,53,UDP,2,243,1150,1,75,1,168,1884.16951,0.144075,4164,9328
192.168.0.38,23240,168.126.63.2,53,UDP,2,302,1151,1,75,1,227,1884.169582,0.005116,117279,354964
192.168.0.38,13873,168.126.63.2,53,UDP,2,444,1152,1,75,1,369,1884.243861,0.006264,95785,471264
192.168.0.38,54878,23.50.0.201,443,TCP,96,78608,330,30,3476,66,75132,1884.250377,120.51356,230,4987
192.168.0.38,15682,168.126.63.2,53,UDP,2,229,1153,1,86,1,143,1884.414621,0.004984,,
192.168.0.38,24650,168.126.63.2,53,UDP,2,274,1154,1,86,1,188,1884.414666,0.014322,48037,105013
192.168.0.38,54879,146.75.50.217,443,TCP,81,29203,331,33,4129,48,25074,1884.42514,204.595551,161,980
192.168.0.38,53216,172.217.25.163,443,UDP,26,7946,1155,12,2861,14,5085,1884.471273,0.16743,136701,242967
192.168.0.38,11070,168.126.63.2,53,UDP,2,220,1156,1,81,1,139,1884.549833,0.006901,93899,161136
192.168.0.38,29986,168.126.63.2,53,UDP,2,277,1157,1,81,1,196,1884.549884,0.01271,50983,123367
192.168.0.38,54880,23.7.234.171,443,TCP,815,875946,332,234,28902,581,847044,1884.555397,51.557351,4484,131433
192.168.0.38,54881,151.101.40.134,443,TCP,121,91318,333,46,5421,75,85897,1884.562222,204.583724,211,3358
192.168.0.38,54841,168.126.63.2,53,UDP,2,278,1158,1,91,1,187,1884.572635,0.005614,129675,266476
192.168.0.38,21744,168.126.63.2,53,UDP,2,242,1159,1,91,1,151,1884.572669,0.00558,130465,216487
192.168.0.38,54882,23.7.234.171,443,TCP,435,373718,334,185,23744,250,349974,1884.597089,50.752567,3742,55165
192.168.0.38,35302,168.126.63.2,53,UDP,2,204,1160,1,70,1,134,1885.033614,0.006063,92363,176810
192.168.0.38,41239,168.126.63.2,53,UDP,2,224,1161,1,70,1,154,1885.033649,0.006029,92884,204345
192.168.0.38,2600,168.126.63.2,53,UDP,2,257,1162,1,75,1,182,1885.033731,0.005946,100908,244870
192.168.0.38,38739,168.126.63.2,53,UDP,2,277,1163,1,75,1,202,1885.033766,0.005911,101505,273388
192.168.0.38,54883,65.8.158.99,443,TCP,905,885602,335,302,23380,603,862222,1885.040559,204.108973,916,33794
192.168.0.38,54884,151.101.64.134,443,TCP,136,107675,336,46,12147,90,95528,1885.040693,203.978613,476,3746
192.168.0.38,54885,151.101.64.134,443,TCP,66,39750,337,27,8082,39,31668,1885.364642,203.654635,317,1243
192.168.0.38,54886,65.8.158.99,443,TCP,52,22109,338,24,3281,28,18828,1885.444734,203.707228,128,739
192.168.0.38,19923,168.126.63.2,53,UDP,2,407,1164,1,75,1,332,1885.449224,0.005898,101729,450322
192.168.0.38,22781,168.126.63.2,53,UDP,2,277,1165,1,75,1,202,1885.449272,0.005851,102546,276192
192.168.0.38,47237,168.126.63.2,53,UDP,2,294,1166,1,75,1,219,1886.414372,0.007327,81888,239115
192.168.0.38,17655,168.126.63.2,53,UDP,2,261,1167,1,75,1,186,1886.414376,0.008705,68925,170936
192.168.0.38,54887,151.101.42.49,443,TCP,38,11045,339,17,2564,21,8481,1886.423615,202.722274,101,334
192.168.0.38,51044,168.126.63.2,53,UDP,2,197,1168,1,75,1,122,1886.628386,0.005894,101798,165592
192.168.0.38,42595,168.126.63.2,53,UDP,2,231,1169,1,75,1,156,1886.628498,0.005783,103752,215804
192.168.0.38,61040,142.250.207.110,443,UDP,75,56115,1170,27,4657,48,51458,1886.636219,0.325575,114431,1264421
192.168.0.38,24727,168.126.63.2,53,UDP,2,211,1171,1,80,1,131,1886.638647,0.004601,,
192.168.0.38,8443,168.126.63.2,53,UDP,2,249,1172,1,80,1,169,1886.639111,0.005609,114102,241041
192.168.0.38,63477,157.240.215.14,443,UDP,23,13049,1173,9,2665,14,10384,1886.645384,0.051584,413306,1610421
192.168.0.38,14822,168.126.63.2,53,UDP,2,174,1174,1,79,1,95,1886.957299,0.004495,,
192.168.0.38,26270,168.126.63.2,53,UDP,2,208,1175,1,79,1,129,1886.957386,0.004871,,
192.168.0.38,52416,142.250.207.109,443,UDP,36,11740,1176,17,4799,19,6941,1886.9628,0.528841,72596,104999
192.168.0.38,58131,142.250.207.99,443,UDP,58,45037,1177,21,3392,37,41645,1887.097722,0.103901,261171,3206513
192.168.0.38,5353,192.168.0.23,5353,UDP,15,15740,1178,13,15210,2,530,1887.360057,2338.694854,52,1
192.168.0.38,50096,168.126.63.1,53,UDP,2,200,1179,1,100,1,100,1891.745179,0.005343,149728,149728
192.168.0.38,58475,168.126.63.2,53,UDP,2,250,1180,1,100,1,150,1891.751532,0.004918,,
192.168.0.38,55341,168.126.63.1,53,UDP,2,296,1181,1,84,1,212,1906.411127,0.004011,,
192.168.0.38,54254,17.248.221.13,443,TCP,36,12187,340,14,3207,22,8980,1906.417943,30.852594,831,2328
192.168.0.38,49872,66.22.228.211,50001,UDP,34374,38991313,1182,17659,19576238,16715,19415075,1913.442263,60.012152,2609636,2588152
192.168.0.38,44523,168.126.63.2,53,UDP,2,198,1183,1,91,1,107,1926.723779,0.00709,102679,120733
192.168.0.38,60430,168.126.63.2,53,UDP,2,242,1184,1,91,1,151,1926.723817,0.007053,103218,171274
192.168.0.38,49509,142.250.76.138,443,UDP,18,6851,1185,8,2421,10,4430,1926.73131,0.270894,71496,130826
192.168.0.47,55357,192.168.0.38,7000,TCP,12,2613,341,6,449,6,2164,1935.172344,0.12988,27656,133292
192.168.0.38,55738,142.250.206.228,443,UDP,25,8542,1186,12,3210,13,5332,1935.230325,1.067518,24055,39958
192.168.0.38,54888,23.7.234.171,443,TCP,15,3841,342,9,2912,6,929,1935.810031,0.192408,121076,38626
192.168.0.38,54889,23.7.234.171,443,TCP,15,3843,343,9,2914,6,929,1935.811129,0.195722,119107,37972
192.168.0.38,54890,23.7.234.171,443,TCP,20,8144,344,11,2961,9,5183,1935.81213,0.202425,117021,204836
192.168.0.38,54891,23.7.234.171,443,TCP,87,66806,345,39,4712,48,62094,1935.992662,0.516413,72995,961927
192.168.0.38,54892,23.7.234.171,443,TCP,23,6688,346,11,1295,12,5393,1935.995494,109.383323,94,394
192.168.0.38,54893,23.7.234.171,443,TCP,26,6906,347,13,1439,13,5467,1935.99952,109.880948,104,398
192.168.0.38,63147,142.250.207.109,443,UDP,28,10819,1187,13,4344,15,6475,1936.427741,0.418173,83104,123872
192.168.0.8,5353,224.0.0.251,5353,UDP,231,35101,1188,231,35101,0,0,1939.064273,1261.860735,222,0
fe80::a85e:a048:2c22:e318,5353,ff02::fb,5353,UDP,190,22641,1189,190,22641,0,0,1939.064273,1218.64971,148,0
192.168.0.8,137,192.168.0.255,137,UDP,85,8468,1190,85,8468,0,0,1940.395638,1217.830337,55,0
192.168.0.38,58352,142.250.207.110,443,UDP,23,10872,1191,11,5849,12,5023,1945.686985,0.325431,143784,123479
192.168.0.7,52010,192.168.0.38,7000,TCP,14,4204,348,7,527,7,3677,1946.550489,0.056541,74565,520259
192.168.0.38,58493,239.255.255.250,1900,UDP,4,872,1192,4,872,0,0,1953.182801,3.01407,2314,0
192.168.0.41,5353,224.0.0.251,5353,UDP,2,200,1193,2,200,0,0,1953.196623,1E-06,,
fe80::9a71:ed7c:ee0c:2040,5353,ff02::fb,5353,UDP,2,240,1194,2,240,0,0,1953.196624,0,,
192.168.0.57,52797,192.168.0.38,7000,TCP,12,2613,349,6,449,6,2164,1961.896385,0.072499,49545,238789
192.168.0.38,29109,168.126.63.2,53,UDP,2,182,1195,1,83,1,99,1965.58782,0.017764,37378,44584
192.168.0.38,37656,168.126.63.2,53,UDP,2,226,1196,1,83,1,143,1965.587907,0.006106,108745,187356
192.168.0.38,65525,142.250.76.142,443,UDP,19,6872,1197,9,2458,10,4414,1965.606708,0.265947,73939,132778
192.168.0.36,62769,192.168.0.38,7000,TCP,12,2613,350,6,449,6,2164,1969.422761,0.065473,54862,264414
192.168.0.38,59390,66.22.228.211,50001,UDP,35422,40296054,1198,18218,20259432,17204,20036622,1973.440921,60.012653,2700688,2670986
192.168.0.38,40179,168.126.63.2,53,UDP,2,258,1199,1,85,1,173,1988.927917,0.005754,118178,240528
192.168.0.38,31521,168.126.63.2,53,UDP,2,230,1200,1,85,1,145,1988.927976,0.125468,5419,9245
192.168.0.38,62586,216.239.32.180,443,UDP,21,8500,1201,10,3582,11,4918,1988.946278,0.272863,105019,144189
192.168.0.38,11488,168.126.63.2,53,UDP,2,198,1202,1,91,1,107,1988.960324,0.004385,,
192.168.0.38,50619,168.126.63.2,53,UDP,2,242,1203,1,91,1,151,1988.96056,0.005251,138640,230051
192.168.0.38,53454,142.250.206.234,443,UDP,19,6893,1204,9,2463,10,4430,1988.966644,0.265516,74210,133475
192.168.0.38,33003,168.126.63.2,53,UDP,2,166,1205,1,75,1,91,2004.643733,0.005785,103716,125842
192.168.0.38,50736,168.126.63.2,53,UDP,2,210,1206,1,75,1,135,2004.643757,0.005762,104130,187434
192.168.0.38,60776,142.250.206.227,443,UDP,27,8018,1207,12,2865,15,5153,2004.650257,0.173698,131953,237331
192.168.0.38,62151,142.250.76.142,443,UDP,27,7695,1208,13,2967,14,4728,2005.141175,9.304535,2551,4065
192.168.0.47,55368,192.168.0.38,7000,TCP,14,4205,351,7,527,7,3678,2012.770813,0.065471,64394,449420
192.168.0.38,61294,168.126.63.1,53,UDP,2,240,1209,1,82,1,158,2018.744981,0.00535,122616,236261
192.168.0.38,50182,168.126.63.1,53,UDP,2,292,1210,1,82,1,210,2018.74515,0.005181,126616,324261
192.168.0.38,54255,17.248.221.4,443,TCP,37,19770,352,16,6650,21,13120,2018.754702,31.047776,1713,3380
192.168.0.38,64003,168.126.63.1,53,UDP,2,248,1211,1,86,1,162,2019.057048,0.005307,129640,244205
192.168.0.38,63555,168.126.63.1,53,UDP,2,300,1212,1,86,1,214,2019.057155,0.005199,132333,329294
192.168.0.38,54706,168.126.63.1,53,UDP,2,240,1213,1,82,1,158,2019.0629,0.003706,,
192.168.0.38,53129,168.126.63.1,53,UDP,2,292,1214,1,82,1,210,2019.062974,0.003633,,
192.168.0.38,54256,17.248.221.8,443,TCP,37,17718,353,17,7468,20,10250,2019.067482,62.016578,963,1322
192.168.0.38,54257,17.248.221.1,443,TCP,26,10641,354,12,2783,14,7858,2019.070792,31.282574,711,2009
192.168.0.38,61235,168.126.63.1,53,UDP,2,254,1215,1,89,1,165,2019.347956,0.003568,,
192.168.0.38,63268,168.126.63.1,53,UDP,2,306,1216,1,89,1,217,2019.348426,0.009125,78027,190246
192.168.0.38,54258,17.248.221.4,443,TCP,44,28106,355,17,5457,27,22649,2019.356267,62.285697,700,2909
192.168.0.38,54259,17.248.221.10,443,TCP,25,11662,356,11,2592,14,9070,2019.360908,31.276992,662,2319
192.168.0.38,54260,17.248.221.1,443,TCP,36,22598,357,14,4005,22,18593,2019.744304,61.897658,517,2403
192.168.0.38,54261,17.248.221.7,443,TCP,28,15840,358,12,3413,16,12427,2019.956465,15.618999,1748,6365
192.168.0.38,54262,17.248.221.1,443,TCP,29,15299,359,12,2690,17,12609,2020.008796,61.302051,351,1645
192.168.0.47,55369,192.168.0.38,7000,TCP,12,2613,360,6,449,6,2164,2020.039312,0.039121,91817,442524
192.168.0.38,54263,17.248.221.1,443,TCP,29,15299,361,12,2690,17,12609,2020.076015,61.051928,352,1652
192.168.0.38,54264,17.248.221.7,443,TCP,45,25353,362,22,9187,23,16166,2020.101168,15.473649,4749,8357
192.168.0.38,54678,168.126.63.1,53,UDP,2,265,1217,1,73,1,192,2020.250032,0.004552,,
192.168.0.38,63820,168.126.63.1,53,UDP,2,221,1218,1,73,1,148,2020.250146,0.004437,,
192.168.0.38,64782,168.126.63.1,53,UDP,2,254,1219,1,89,1,165,2020.255219,0.004534,,
192.168.0.38,54265,17.32.194.2,443,TCP,21,11118,363,11,3881,10,7237,2020.261959,15.313503,2027,3780
192.168.0.38,54266,17.248.221.7,443,TCP,24,13261,364,11,3417,13,9844,2020.648283,14.9265,1831,5275
192.168.0.38,58851,168.126.63.1,53,UDP,2,284,1220,1,92,1,192,2020.849787,0.076719,9593,20021
192.168.0.38,51927,168.126.63.1,53,UDP,2,224,1221,1,92,1,132,2020.849854,0.076652,9601,13776
192.168.0.38,54267,17.42.251.13,443,TCP,26,13159,365,14,3977,12,9182,2020.905738,60.872017,522,1206
192.168.0.38,50741,168.126.63.1,53,UDP,2,258,1222,1,91,1,167,2020.927124,0.003553,,
192.168.0.38,55277,168.126.63.1,53,UDP,2,252,1223,1,96,1,156,2022.437774,0.004506,,
192.168.0.38,55715,168.126.63.1,53,UDP,2,208,1224,1,96,1,112,2022.437866,0.004414,,
192.168.0.38,49222,142.250.207.97,443,UDP,40,20386,1225,21,6414,19,13972,2022.454917,0.798715,64243,139944
192.168.0.38,51254,142.250.207.97,443,UDP,31,16220,1226,16,5118,15,11102,2023.258871,0.661496,61896,134265
192.168.0.38,63503,142.250.207.97,443,UDP,32,17350,1227,16,5302,16,12048,2023.925353,0.613904,69092,157001
192.168.0.38,56204,142.250.207.97,443,UDP,34,17740,1228,17,5563,17,12177,2024.544859,0.594917,74807,163747
192.168.0.38,56033,142.250.207.97,443,UDP,34,17726,1229,17,5563,17,12163,2025.120625,0.591252,75270,164572
192.168.0.38,56446,142.250.207.97,443,UDP,43,29097,1230,20,7701,23,21396,2025.725585,0.70083,87907,244236
192.168.0.38,57400,168.126.63.1,53,UDP,2,341,1231,1,82,1,259,2030.133478,0.004345,,
192.168.0.38,64404,168.126.63.1,53,UDP,2,203,1232,1,75,1,128,2030.135966,0.004364,,
192.168.0.38,61650,168.126.63.1,53,UDP,2,302,1233,1,73,1,229,2030.138238,0.005507,106046,332667
192.168.0.38,58928,168.126.63.1,53,UDP,2,362,1234,1,103,1,259,2030.143953,0.004357,,
192.168.0.38,55538,168.126.63.1,53,UDP,2,361,1235,1,95,1,266,2030.146335,0.005315,142991,400376
192.168.0.38,62536,168.126.63.1,53,UDP,2,296,1236,1,84,1,212,2030.296452,0.004811,,
192.168.0.38,60681,168.126.63.1,53,UDP,2,200,1237,1,78,1,122,2030.321239,0.004469,,
192.168.0.38,54888,168.126.63.1,53,UDP,2,220,1238,1,78,1,142,2030.321329,0.00438,,
192.168.0.38,54900,192.168.0.7,7000,TCP,12,2539,366,6,449,6,2090,2030.970362,0.131703,27273,126952
192.168.0.38,52674,66.22.228.211,50001,UDP,35476,40358003,1239,18156,20214125,17320,20143878,2033.440562,60.01007,2694764,2685399
192.168.0.38,54357,168.126.63.1,53,UDP,2,288,1240,1,97,1,191,2034.555214,0.004891,,
192.168.0.38,49616,168.126.63.1,53,UDP,2,258,1241,1,91,1,167,2034.560907,0.005227,139276,255595
192.168.0.38,54268,17.56.10.43,443,TCP,27,8466,367,11,2012,16,6454,2034.574803,90.785463,177,568
192.168.0.7,52028,192.168.0.38,7000,TCP,15,4270,368,7,527,8,3743,2035.982291,0.077805,54186,384859
192.168.0.15,52330,192.168.0.38,7000,TCP,12,2613,369,6,449,6,2164,2043.005757,0.032224,111469,537239
192.168.0.38,29964,168.126.63.2,53,UDP,2,242,1242,1,91,1,151,2050.986928,0.005367,135643,225079
192.168.0.38,56440,142.250.206.234,443,UDP,19,6897,1243,9,2467,10,4430,2050.996557,0.263421,74921,134537
192.168.0.38,49813,168.126.63.1,53,UDP,2,284,1244,1,78,1,206,2052.186842,0.004616,,
192.168.0.38,54269,52.11.249.51,443,TCP,135,117558,370,84,108353,51,9205,2052.194142,121.120688,7156,607
192.168.0.38,63567,142.250.206.227,443,UDP,18,7118,1245,8,2391,10,4727,2059.252715,0.155451,123048,243266
192.168.0.38,45372,168.126.63.2,53,UDP,2,182,1246,1,83,1,99,2062.293303,0.004905,,
192.168.0.38,47391,168.126.63.2,53,UDP,2,226,1247,1,83,1,143,2062.293383,0.004825,,
192.168.0.38,58044,142.250.207.110,443,UDP,19,6877,1248,9,2463,10,4414,2062.29899,0.265045,74342,133230
192.168.0.42,59914,192.168.0.38,7000,TCP,12,2613,371,6,449,6,2164,2066.684378,0.135838,26443,127445
192.168.0.38,60663,168.126.63.1,53,UDP,2,244,1249,1,84,1,160,2068.37124,0.004742,,
192.168.0.38,54270,17.248.221.14,443,TCP,41,20837,372,18,5519,23,15318,2068.374718,2.090946,21115,58606
192.168.0.38,57767,168.126.63.1,53,UDP,2,327,1250,1,114,1,213,2069.094416,0.004809,,
192.168.0.38,53894,168.126.63.1,53,UDP,2,258,1251,1,114,1,144,2069.094576,0.004649,,
192.168.0.38,54979,168.126.63.1,53,UDP,2,287,1252,1,101,1,186,2069.099866,0.004162,,
192.168.0.38,54271,52.219.124.150,443,TCP,144,107304,373,81,97517,63,9787,2069.105618,3.69207,211300,21206
192.168.0.38,54272,17.248.221.14,443,TCP,35,16856,374,15,7643,20,9213,2070.546992,30.701093,1991,2400
192.168.0.38,54273,17.248.221.14,443,TCP,66,31503,375,28,9787,38,21716,2071.337929,4.887812,16018,35543
192.168.0.38,54274,52.219.124.150,443,TCP,34,10067,376,15,2656,19,7411,2071.952631,1.872546,11347,31661
192.168.0.38,54275,17.248.221.14,443,TCP,36,13057,377,15,3999,21,9058,2072.357045,30.540831,1047,2372
192.168.0.38,13517,168.126.63.1,53,UDP,2,194,1253,1,89,1,105,2072.419823,0.004279,,
192.168.0.38,11693,168.126.63.1,53,UDP,2,238,1254,1,89,1,149,2072.420193,0.005698,124956,209196
192.168.0.38,62887,142.250.206.227,443,UDP,19,6642,1255,9,2298,10,4344,2072.42681,0.211322,86995,164450
192.168.0.38,59413,239.255.255.250,1900,UDP,4,872,1256,4,872,0,0,2073.183882,3.024545,2306,0
192.168.0.38,57110,66.22.228.211,50001,UDP,33532,37910742,1257,18181,20202579,15351,17708163,2093.440038,60.023853,2692606,2360150
192.168.0.38,56744,142.250.207.110,443,UDP,35,8573,1258,17,3407,18,5166,2094.818915,1.066478,25557,38751
192.168.0.38,58171,168.126.63.1,53,UDP,2,364,1259,1,76,1,288,2095.621829,0.004068,,
192.168.0.38,60416,168.126.63.1,53,UDP,2,301,1260,1,76,1,225,2095.621961,0.003936,,
192.168.0.38,58385,168.126.63.1,53,UDP,2,249,1261,1,85,1,164,2095.626413,0.004422,,
192.168.0.38,54276,104.91.76.24,443,TCP,33,21664,378,11,1634,22,20030,2095.632718,8.250433,1584,19422
192.168.0.38,65295,168.126.63.1,53,UDP,2,344,1262,1,75,1,269,2110.405401,0.00364,,
192.168.0.38,58758,168.126.63.1,53,UDP,2,284,1263,1,75,1,209,2110.405472,0.003569,,
192.168.0.38,64831,168.126.63.1,53,UDP,2,288,1264,1,106,1,182,2110.409613,0.003771,,
192.168.0.38,54096,168.126.63.1,53,UDP,2,228,1265,1,106,1,122,2110.409699,0.006379,132936,153002
192.168.0.38,54277,40.70.161.102,443,TCP,26,9027,379,12,2628,14,6399,2110.417685,62.272076,337,822
192.168.0.38,29736,168.126.63.2,53,UDP,2,198,1266,1,91,1,107,2113.392504,0.005044,144329,169706
192.168.0.38,14541,168.126.63.2,53,UDP,2,232,1267,1,91,1,141,2113.39258,0.004968,,
192.168.0.38,59843,142.250.206.234,443,UDP,19,6894,1268,9,2464,10,4430,2113.398093,0.277331,71077,127789
192.168.0.38,5027,168.126.63.2,53,UDP,2,166,1269,1,75,1,91,2125.422101,0.005502,109051,132315
192.168.0.38,6467,168.126.63.2,53,UDP,2,210,1270,1,75,1,135,2125.422193,0.005411,110885,199593
192.168.0.38,49970,142.250.206.195,443,UDP,28,8096,1271,13,2942,15,5154,2125.428191,0.180662,130276,228227
192.168.0.23,51360,192.168.0.38,7000,TCP,12,2613,380,6,449,6,2164,2151.624436,0.042124,85272,410977
192.168.0.38,59694,66.22.228.211,50001,UDP,35720,40627904,1272,18357,20413184,17363,20214720,2153.439337,60.003926,2721579,2695119
192.168.0.38,56540,168.126.63.2,53,UDP,2,182,1273,1,83,1,99,2155.666552,0.056835,11682,13935
192.168.0.38,35048,168.126.63.2,53,UDP,2,226,1274,1,83,1,143,2155.666611,0.005214,127349,219409
192.168.0.38,59764,142.250.76.142,443,UDP,19,6875,1275,9,2461,10,4414,2155.724323,0.258765,76084,136463
192.168.0.38,15274,168.126.63.2,53,UDP,2,198,1276,1,91,1,107,2174.394413,0.005458,133382,156834
192.168.0.38,34351,168.126.63.2,53,UDP,2,242,1277,1,91,1,151,2174.394451,0.005419,134342,222919
192.168.0.38,51582,172.217.161.234,443,UDP,19,6894,1278,9,2464,10,4430,2174.400338,0.271816,72519,130382
192.168.0.38,57148,239.255.255.250,1900,UDP,4,872,1279,4,872,0,0,2193.184001,3.021833,2308,0
192.168.0.38,50671,142.250.76.142,443,UDP,19,6876,1280,9,2462,10,4414,2207.042575,0.260759,75533,135420
192.168.0.38,50385,168.126.63.2,53,UDP,2,162,1281,1,73,1,89,2207.164148,0.006181,94483,115191
192.168.0.38,23611,168.126.63.2,53,UDP,2,206,1282,1,73,1,133,2207.164188,0.00614,95114,173289
192.168.0.38,59053,142.250.76.129,443,UDP,21,11708,1283,10,2986,11,8722,2207.170876,0.138702,172225,503064
192.168.0.38,65416,66.22.228.211,50001,UDP,34778,39533830,1284,18257,20331324,16521,19202506,2213.437741,60.008582,2710455,2559967
192.168.0.38,63022,168.126.63.1,53,UDP,2,296,1285,1,84,1,212,2213.764825,0.005362,125326,316299
192.168.0.38,54278,17.248.221.13,443,TCP,40,20769,381,17,5447,23,15322,2213.775937,2.201938,19789,55667
192.168.0.38,62102,168.126.63.1,53,UDP,2,327,1286,1,114,1,213,2214.417265,0.004302,,
192.168.0.38,63890,168.126.63.1,53,UDP,2,258,1287,1,114,1,144,2214.417414,0.004153,,
192.168.0.38,54279,52.219.124.86,443,TCP,145,107036,382,79,97087,66,9949,2214.423566,2.62241,296176,30350
192.168.0.38,54280,17.248.221.8,443,TCP,38,17046,383,15,7640,23,9406,2215.924853,30.670749,1992,2453
192.168.0.38,54281,17.248.221.8,443,TCP,69,30813,384,32,10060,37,20753,2216.640273,5.089924,15811,32618
192.168.0.7,52073,192.168.0.38,7000,TCP,12,2612,385,6,449,6,2163,2222.611994,0.052322,68651,330721
192.168.0.38,61477,168.126.63.1,53,UDP,2,207,1288,1,76,1,131,2223.882608,0.00447,,
192.168.0.38,64800,168.126.63.1,53,UDP,2,237,1289,1,85,1,152,2223.888613,0.004621,,
192.168.0.38,54282,211.249.201.68,443,TCP,29,12461,386,15,2790,14,9671,2223.909565,61.864288,360,1250
192.168.0.38,24776,168.126.63.2,53,UDP,2,198,1290,1,91,1,107,2234.668039,0.005506,132219,155466
192.168.0.38,16947,168.126.63.2,53,UDP,2,242,1291,1,91,1,151,2234.668128,0.005416,134416,223042
192.168.0.38,50251,142.250.206.202,443,UDP,19,6896,1292,9,2466,10,4430,2234.674243,0.252241,78210,140500
192.168.0.38,40899,168.126.63.2,53,UDP,2,166,1293,1,75,1,91,2247.064411,0.004662,,
192.168.0.38,42398,168.126.63.2,53,UDP,2,210,1294,1,75,1,135,2247.064439,0.004635,,
192.168.0.38,52586,142.250.207.99,443,UDP,26,7949,1295,12,2864,14,5085,2247.069571,0.141956,161402,286567
192.168.0.38,8262,168.126.63.2,53,UDP,2,182,1296,1,83,1,99,2255.849377,0.006127,108372,129263
192.168.0.38,58828,168.126.63.2,53,UDP,2,223,1297,1,83,1,140,2255.849449,0.006057,109625,184910
192.168.0.38,62584,142.250.206.206,443,UDP,19,6876,1298,9,2462,10,4414,2255.856483,0.2607,75550,135450
192.168.0.38,60701,66.22.228.211,50001,UDP,35609,40507090,1299,18287,20333750,17322,20173340,2273.436827,60.002777,2711041,2689654
192.168.0.35,49183,192.168.0.38,7000,TCP,13,2679,387,6,449,7,2230,2283.773166,0.050531,71085,353050
192.168.0.7,52093,192.168.0.38,7000,TCP,12,2612,388,6,449,6,2163,2289.183099,0.037685,95316,459174
192.168.0.38,64474,168.126.63.2,53,UDP,2,186,1300,1,85,1,101,2290.000269,0.0048,,
192.168.0.38,63131,168.126.63.2,53,UDP,2,244,1301,1,85,1,159,2290.00032,0.007767,87549,163769
192.168.0.38,56539,172.217.161.206,443,UDP,28,15891,1302,14,6668,14,9223,2290.00997,0.361981,147366,203833
192.168.0.38,10525,168.126.63.2,53,UDP,2,198,1303,1,91,1,107,2296.287893,0.005159,141112,165923
192.168.0.38,8779,168.126.63.2,53,UDP,2,232,1304,1,91,1,141,2296.287982,0.005069,143618,222529
192.168.0.38,64854,142.250.206.234,443,UDP,19,6895,1305,9,2465,10,4430,2296.293852,0.263402,74866,134547
192.168.0.54,61207,192.168.0.38,7000,TCP,15,4271,389,8,593,7,3678,2304.381219,0.098505,48159,298705
192.168.0.38,60348,142.250.206.206,443,UDP,27,7660,1306,13,2961,14,4699,2308.580125,0.373503,63421,100647
192.168.0.38,56911,239.255.255.250,1900,UDP,4,872,1307,4,872,0,0,2313.189111,3.022338,2308,0
192.168.0.38,50810,168.126.63.1,53,UDP,2,239,1308,1,82,1,157,2326.701471,0.003802,,
192.168.0.38,59208,168.126.63.1,53,UDP,2,180,1309,1,82,1,98,2326.701497,0.003777,,
192.168.0.38,54283,23.207.176.211,443,TCP,27,9105,390,12,1695,15,7410,2326.728275,30.490602,444,1944
192.168.0.38,55671,168.126.63.1,53,UDP,2,253,1310,1,87,1,166,2326.729248,0.005222,133282,254308
192.168.0.38,64368,168.126.63.1,53,UDP,2,190,1311,1,87,1,103,2326.729724,0.007149,97356,115260
192.168.0.38,54284,23.207.176.211,443,TCP,28,8836,391,13,1713,15,7123,2326.738085,30.832494,444,1848
192.168.0.38,54285,104.91.77.72,443,TCP,30,9997,392,13,2329,17,7668,2326.739761,1.029149,18104,59606
192.168.0.38,54286,104.91.77.72,443,TCP,30,9468,393,14,1878,16,7590,2327.171301,0.950041,15814,63913
192.168.0.38,61002,168.126.63.1,53,UDP,2,298,1312,1,96,1,202,2327.172322,0.005414,141854,298485
192.168.0.38,64904,168.126.63.1,53,UDP,2,256,1313,1,96,1,160,2327.172439,0.005296,145015,241691
192.168.0.38,62657,168.126.63.1,53,UDP,2,230,1314,1,78,1,152,2327.178357,0.005005,124675,242957
192.168.0.38,54287,17.253.115.202,443,TCP,30,9474,394,14,2203,16,7271,2327.185727,3.372014,5226,17250
192.168.0.38,54288,23.207.176.211,443,TCP,28,8836,395,13,1713,15,7123,2327.646464,30.787968,445,1850
192.168.0.38,54289,104.91.77.72,443,TCP,28,9336,396,13,1812,15,7524,2327.649729,0.39812,36411,151190
192.168.0.38,54290,104.91.76.24,443,TCP,37,18507,397,16,2245,21,16262,2328.932479,0.399655,44938,325520
192.168.0.38,50543,168.126.63.1,53,UDP,2,266,1315,1,95,1,171,2329.172216,0.00465,,
192.168.0.38,58836,168.126.63.1,53,UDP,2,254,1316,1,95,1,159,2329.172608,0.004259,,
192.168.0.38,54291,17.36.203.0,443,TCP,27,13603,398,12,2002,15,11601,2329.180465,1.067523,15002,86937
192.168.0.38,49160,168.126.63.1,53,UDP,2,372,1317,1,81,1,291,2329.191747,0.005376,120535,433035
192.168.0.38,59007,168.126.63.1,53,UDP,2,309,1318,1,81,1,228,2329.191875,0.005248,123475,347560
192.168.0.38,54292,104.91.76.24,443,TCP,56,41681,399,19,3934,37,37747,2329.454454,118.556041,265,2547
192.168.0.38,56532,168.126.63.1,53,UDP,2,376,1319,1,81,1,295,2329.877177,0.005344,121257,441616
192.168.0.38,55330,168.126.63.1,53,UDP,2,331,1320,1,81,1,250,2329.877244,0.005276,122820,379075
192.168.0.38,60307,168.126.63.1,53,UDP,2,245,1321,1,84,1,161,2329.883315,0.005521,121717,233291
192.168.0.38,54293,23.50.121.168,443,TCP,42,16716,400,17,5228,25,11488,2329.890509,118.542758,352,775
192.168.0.38,64284,168.126.63.1,53,UDP,2,296,1322,1,84,1,212,2330.103632,0.005398,124490,314190
192.168.0.38,54294,17.248.221.2,443,TCP,39,20792,401,16,5382,23,15410,2330.112916,2.203531,19539,55946
192.168.0.38,63975,168.126.63.1,53,UDP,2,291,1323,1,95,1,196,2330.185297,0.112473,6757,13941
192.168.0.38,51328,168.126.63.1,53,UDP,2,231,1324,1,95,1,136,2330.185387,0.222033,3422,4900
192.168.0.38,54295,17.120.252.47,443,TCP,30,12683,402,15,5112,15,7571,2330.243327,31.566513,1295,1918
192.168.0.38,52846,168.126.63.1,53,UDP,2,272,1325,1,98,1,174,2330.298387,0.005191,151030,268156
192.168.0.38,49670,168.126.63.1,53,UDP,2,212,1326,1,98,1,114,2330.407789,0.111528,7029,8177
192.168.0.38,54296,17.120.252.50,443,TCP,31,12737,403,15,5112,16,7625,2330.677565,31.132278,1313,1959
192.168.0.38,54297,17.120.252.50,443,TCP,34,15296,404,16,6531,18,8765,2330.678518,31.135366,1678,2252
192.168.0.38,51842,168.126.63.1,53,UDP,2,327,1327,1,114,1,213,2330.780431,0.004762,,
192.168.0.38,54934,168.126.63.1,53,UDP,2,258,1328,1,114,1,144,2330.780504,0.004689,,
192.168.0.38,54298,52.219.36.29,443,TCP,200,153158,405,109,141859,91,11299,2330.786656,4.0122,282855,22529
192.168.0.38,54299,17.248.221.2,443,TCP,37,17052,406,15,7706,22,9346,2332.44463,30.689314,2008,2436
192.168.0.38,54300,17.248.221.2,443,TCP,66,31479,407,29,9869,37,21610,2333.185012,5.737055,13761,30133
192.168.0.38,60028,66.22.228.211,50001,UDP,35916,40848103,1329,18459,20530331,17457,20317772,2333.435489,60.010524,2736897,2708561
192.168.0.38,54301,52.219.36.29,443,TCP,38,10282,408,18,2817,20,7465,2333.810451,1.881409,11978,31742
192.168.0.38,54302,17.248.221.2,443,TCP,36,13058,409,15,3999,21,9059,2334.188574,30.562636,1046,2371
192.168.0.38,5353,192.168.0.88,5353,UDP,8,3377,1330,7,3073,1,304,2342.346998,839.293125,29,2
192.168.0.38,55512,168.126.63.1,53,UDP,2,252,1331,1,96,1,156,2343.352314,0.005008,153354,249201
192.168.0.38,55203,168.126.63.1,53,UDP,2,208,1332,1,96,1,112,2343.352425,0.004896,,
192.168.0.38,51791,142.250.76.129,443,UDP,31,16230,1333,16,5118,15,11112,2343.370551,0.617202,66338,144030
192.168.0.38,64849,142.250.76.129,443,UDP,33,17413,1334,17,5377,16,12036,2344.060712,0.608436,70699,158254
192.168.0.38,52309,142.250.76.129,443,UDP,35,17826,1335,18,5644,17,12182,2344.673091,0.650718,69387,149766
192.168.0.38,55259,142.250.76.129,443,UDP,33,17644,1336,16,5482,17,12162,2345.298603,0.707072,62024,137604
192.168.0.38,60753,142.250.76.129,443,UDP,44,29167,1337,19,7628,25,21539,2345.986226,0.705794,86461,244139
192.168.0.38,25988,168.126.63.2,53,UDP,2,198,1338,1,91,1,107,2358.349704,0.005741,126807,149102
192.168.0.38,39030,168.126.63.2,53,UDP,2,232,1339,1,91,1,141,2358.349767,0.005678,128214,198661
192.168.0.38,62418,172.217.161.234,443,UDP,19,6894,1340,9,2464,10,4430,2358.356015,0.265772,74168,133347
192.168.0.38,27732,168.126.63.2,53,UDP,2,182,1341,1,83,1,99,2358.699927,0.005175,128309,153043
192.168.0.38,24432,168.126.63.2,53,UDP,2,226,1342,1,83,1,143,2358.699996,0.005105,130068,224094
192.168.0.38,61782,142.250.76.142,443,UDP,19,6873,1343,9,2459,10,4414,2358.705836,0.262573,74920,134484
192.168.0.38,6450,168.126.63.2,53,UDP,2,166,1344,1,75,1,91,2359.232755,0.006578,91213,110671
192.168.0.38,18846,168.126.63.2,53,UDP,2,210,1345,1,75,1,135,2359.2328,0.006534,91827,165289
192.168.0.38,57467,142.250.207.99,443,UDP,34,8823,1346,16,3275,18,5548,2359.239707,10.323945,2537,4299
192.168.0.36,62775,192.168.0.38,7000,TCP,12,2613,410,6,449,6,2164,2385.754155,0.041209,87165,420102
192.168.0.38,57718,66.22.228.211,50001,UDP,34746,39451848,1347,18118,20122680,16628,19329168,2393.434291,57.946895,2778085,2668535
192.168.0.7,52109,192.168.0.38,7000,TCP,12,2612,411,6,449,6,2163,2394.598065,0.041653,86236,415432
192.168.0.42,59917,192.168.0.38,7000,TCP,12,2613,412,6,449,6,2164,2395.330351,0.087655,40978,197501
192.168.0.38,51701,142.250.76.142,443,UDP,19,6874,1348,9,2460,10,4414,2409.344516,0.257583,76402,137089
192.168.0.38,39125,168.126.63.2,53,UDP,2,198,1349,1,91,1,107,2419.898071,0.005087,143109,168272
192.168.0.38,43413,168.126.63.2,53,UDP,2,242,1350,1,91,1,151,2419.898137,0.005022,144962,240541
192.168.0.38,54917,172.217.161.234,443,UDP,19,6890,1351,9,2460,10,4430,2419.903764,0.272313,72269,130144
192.168.0.38,51155,168.126.63.1,53,UDP,2,296,1352,1,84,1,212,2429.890565,0.005553,121015,305420
192.168.0.38,54303,17.248.221.3,443,TCP,38,20878,413,16,5438,22,15440,2429.900956,2.20529,19727,56010
192.168.0.38,49946,168.126.63.1,53,UDP,2,327,1353,1,114,1,213,2430.615936,0.004497,,
192.168.0.38,60965,168.126.63.1,53,UDP,2,258,1354,1,114,1,144,2430.615991,0.004441,,
192.168.0.38,54304,52.219.124.86,443,TCP,187,140699,414,102,129724,85,10975,2430.622772,3.817877,271824,22997
192.168.0.38,54305,17.248.221.3,443,TCP,38,17223,415,15,7800,23,9423,2432.252563,28.613864,2180,2634
192.168.0.38,54306,17.248.221.3,443,TCP,63,30382,416,27,9718,36,20664,2432.981313,3.883373,20019,42569
192.168.0.38,60265,239.255.255.250,1900,UDP,4,872,1355,4,872,0,0,2433.194715,3.022241,2308,0
192.168.0.38,53717,168.126.63.1,53,UDP,2,212,1356,1,82,1,130,2441.004528,0.004813,,
192.168.0.38,123,17.253.68.123,123,UDP,1,90,1357,1,90,0,0,2441.025846,0,,
192.168.0.38,65071,168.126.63.1,53,UDP,2,382,1358,1,72,1,310,2442.590114,0.005055,113946,490603
192.168.0.38,55368,168.126.63.1,53,UDP,2,320,1359,1,72,1,248,2442.590862,0.004309,,
192.168.0.38,61792,168.126.63.1,53,UDP,2,250,1360,1,86,1,164,2442.596822,0.004638,,
192.168.0.38,54307,104.91.73.144,443,TCP,20,8250,417,10,1641,10,6609,2442.603079,10.300831,1274,5132
192.168.0.38,56380,168.126.63.1,53,UDP,2,376,1361,1,82,1,294,2442.652088,0.005459,120168,430848
192.168.0.38,58919,168.126.63.1,53,UDP,2,443,1362,1,82,1,361,2442.652187,0.005359,122410,538906
192.168.0.38,60322,168.126.63.1,53,UDP,2,245,1363,1,84,1,161,2442.6584,0.006224,107969,206940
192.168.0.38,54308,175.207.14.82,443,TCP,22,12557,418,9,1907,13,10650,2442.666068,10.237773,1490,8322
192.168.0.38,57752,66.22.228.211,50001,UDP,34699,39372955,1364,18351,20431539,16348,18941416,2451.365989,59.992345,2724552,2525844
192.168.0.38,14728,168.126.63.2,53,UDP,2,182,1365,1,83,1,99,2454.742039,0.005018,132323,157831
192.168.0.38,21670,168.126.63.2,53,UDP,2,226,1366,1,83,1,143,2454.742148,0.004909,,
192.168.0.38,64375,172.217.161.238,443,UDP,19,6874,1367,9,2460,10,4414,2454.747534,0.271251,72552,130182
192.168.0.38,56964,168.126.63.1,53,UDP,2,344,1368,1,75,1,269,2469.069885,0.004546,,
192.168.0.38,63223,168.126.63.1,53,UDP,2,284,1369,1,75,1,209,2469.069974,0.004457,,
192.168.0.38,55979,168.126.63.1,53,UDP,2,288,1370,1,106,1,182,2469.075397,0.00387,,
192.168.0.38,54309,52.177.138.113,443,TCP,26,8774,419,12,2384,14,6390,2469.091137,31.227645,610,1637
192.168.0.38,27552,168.126.63.2,53,UDP,2,198,1371,1,91,1,107,2479.024737,0.004533,,
192.168.0.38,28282,168.126.63.2,53,UDP,2,232,1372,1,91,1,141,2479.024879,0.00439,,
192.168.0.38,64448,172.217.25.170,443,UDP,19,6893,1373,9,2463,10,4430,2479.031943,0.250921,78526,141239
192.168.0.38,60840,168.126.63.2,53,UDP,2,166,1374,1,75,1,91,2491.514636,0.005042,119000,144387
192.168.0.38,12679,168.126.63.2,53,UDP,2,210,1375,1,75,1,135,2491.514695,0.004982,,
192.168.0.38,61224,142.250.207.99,443,UDP,30,8233,1376,14,3011,16,5222,2491.520419,0.208624,115461,200245
192.168.0.51,52164,192.168.0.38,7000,TCP,12,2613,420,6,449,6,2164,2491.944875,0.040578,88520,426635
192.168.0.15,52343,192.168.0.38,7000,TCP,14,4205,421,7,527,7,3678,2493.230969,0.044303,95162,664153
192.168.0.38,51292,172.217.161.238,443,UDP,19,6872,1377,9,2458,10,4414,2507.379712,0.265942,73940,132780
192.168.0.38,58197,66.22.228.211,50001,UDP,34880,39601411,1378,18363,20428076,16517,19173335,2511.365695,60.01699,2722972,2555720
192.168.0.38,60079,168.126.63.2,53,UDP,2,164,1379,1,74,1,90,2522.57983,0.004223,,
192.168.0.38,15636,168.126.63.2,53,UDP,2,173,1380,1,74,1,99,2522.579891,0.004161,,
192.168.0.38,59969,142.250.206.228,443,UDP,565,381608,1381,170,27437,395,354171,2522.584655,14.298271,15351,198161
192.168.0.38,5237,168.126.63.2,53,UDP,2,188,1382,1,86,1,102,2524.282347,0.005219,131826,156351
192.168.0.38,60117,168.126.63.2,53,UDP,2,229,1383,1,86,1,143,2524.282464,0.005102,134849,224225
192.168.0.38,54733,142.250.207.110,443,UDP,15,7275,1384,7,2124,8,5151,2524.288653,0.140229,121173,293862
192.168.0.38,17449,168.126.63.2,53,UDP,2,421,1385,1,75,1,346,2527.552396,0.005054,118717,547685
192.168.0.38,32850,168.126.63.2,53,UDP,2,210,1386,1,75,1,135,2527.552444,0.005005,119880,215784
192.168.0.38,59334,142.250.207.99,443,UDP,12,5621,1387,6,1758,6,3863,2527.55321,0.131123,107258,235687
192.168.0.38,10024,168.126.63.2,53,UDP,2,166,1388,1,75,1,91,2527.665891,0.004113,,
192.168.0.38,64686,168.126.63.2,53,UDP,2,200,1389,1,75,1,125,2527.665942,0.004063,,
192.168.0.38,56930,172.217.25.174,443,UDP,16,6243,1390,7,2160,9,4083,2527.670368,0.144782,119351,225608
192.168.0.69,5353,224.0.0.251,5353,UDP,2,200,1391,2,200,0,0,2529.794858,1E-06,,
fe80::6211:b00c:822:36e4,5353,ff02::fb,5353,UDP,2,240,1392,2,240,0,0,2529.794859,1E-06,,
192.168.0.38,57116,168.126.63.2,53,UDP,2,509,1393,1,71,1,438,2536.567776,0.005151,110269,680256
192.168.0.38,27890,168.126.63.2,53,UDP,2,202,1394,1,71,1,131,2536.567835,0.005092,111547,205813
192.168.0.38,65195,172.217.161.214,443,UDP,21,12392,1395,9,2551,12,9841,2536.573448,0.141031,144705,558231
192.168.0.38,9707,168.126.63.1,53,UDP,2,190,1396,1,87,1,103,2536.717188,0.004223,,
192.168.0.38,4367,168.126.63.1,53,UDP,2,234,1397,1,87,1,147,2536.717228,0.004182,,
192.168.0.38,55067,142.250.206.202,443,UDP,17,7142,1398,8,2701,9,4441,2536.721865,0.174695,123689,203371
192.168.0.38,30171,168.126.63.2,53,UDP,2,242,1399,1,81,1,161,2537.163821,0.00456,,
192.168.0.38,7828,168.126.63.2,53,UDP,2,222,1400,1,81,1,141,2537.163862,0.004519,,
192.168.0.38,63871,142.250.206.202,443,UDP,62,42583,1401,24,4811,38,37772,2537.168848,0.401722,95807,752201
192.168.0.38,47844,168.126.63.1,53,UDP,2,211,1402,1,83,1,128,2539.919967,0.003729,,
192.168.0.38,42289,168.126.63.1,53,UDP,2,245,1403,1,83,1,162,2539.920039,0.003658,,
192.168.0.38,21300,168.126.63.2,53,UDP,2,247,1404,1,91,1,156,2539.922305,0.005866,124105,212751
192.168.0.38,41059,168.126.63.2,53,UDP,2,298,1405,1,91,1,207,2539.922378,0.006552,111111,252747
192.168.0.38,64248,172.217.161.238,443,UDP,23,12686,1406,11,4832,12,7854,2539.92417,0.244639,158012,256835
192.168.0.38,54903,211.249.222.33,443,TCP,49,29721,422,22,6855,27,22866,2539.929128,56.349593,973,3246
192.168.0.38,35585,168.126.63.2,53,UDP,2,198,1407,1,91,1,107,2539.956615,0.005719,127294,149676
192.168.0.38,46852,168.126.63.2,53,UDP,2,242,1408,1,91,1,151,2539.956642,0.005692,127898,212227
192.168.0.38,54341,142.250.76.138,443,UDP,27,8176,1409,13,3114,14,5062,2539.962684,0.572924,43482,70683
192.168.0.38,27533,168.126.63.2,53,UDP,2,244,1410,1,74,1,170,2540.139735,0.005034,117600,270162
192.168.0.38,13414,168.126.63.2,53,UDP,2,289,1411,1,74,1,215,2540.139764,0.005004,118305,343725
192.168.0.38,51429,168.126.63.2,53,UDP,2,247,1412,1,80,1,167,2540.140796,0.005505,116257,242688
192.168.0.38,47016,168.126.63.2,53,UDP,2,298,1413,1,80,1,218,2540.140844,0.005457,117280,319589
192.168.0.38,54904,211.231.116.151,443,TCP,1754,2510930,423,69,6259,1685,2504671,2540.145059,15.254633,3282,1313526
192.168.0.38,54905,211.231.116.151,443,TCP,2288,3282023,424,111,8976,2177,3273047,2540.145124,16.154876,4444,1620834
192.168.0.38,54906,121.53.201.236,443,TCP,116,93217,425,37,4157,79,89060,2540.146438,180.072073,184,3956
192.168.0.38,4455,168.126.63.2,53,UDP,2,213,1414,1,79,1,134,2540.203804,0.003881,,
192.168.0.38,42012,168.126.63.2,53,UDP,2,264,1415,1,79,1,185,2540.203854,0.006181,102248,239443
192.168.0.38,14924,168.126.63.2,53,UDP,2,364,1416,1,76,1,288,2540.204582,0.005453,111498,422519
192.168.0.38,5285,168.126.63.2,53,UDP,2,344,1417,1,76,1,268,2540.20463,0.005406,112467,396596
192.168.0.38,28019,168.126.63.2,53,UDP,2,180,1418,1,74,1,106,2540.206395,0.004419,,
192.168.0.38,26878,168.126.63.2,53,UDP,2,205,1419,1,74,1,131,2540.206425,0.003611,,
192.168.0.38,54907,121.53.218.25,443,TCP,35,8147,426,17,2310,18,5837,2540.210232,180.031459,102,259
192.168.0.38,54908,23.67.53.19,443,TCP,352,437108,427,45,5091,307,432017,2540.210368,20.276527,2008,170450
192.168.0.38,54909,211.231.100.117,443,TCP,121,119436,428,30,3801,91,115635,2540.210967,181.058145,167,5109
192.168.0.38,29629,168.126.63.2,53,UDP,2,549,1420,1,91,1,458,2540.391631,0.014879,48928,246253
192.168.0.38,7508,168.126.63.2,53,UDP,2,242,1421,1,91,1,151,2540.391668,0.014841,49053,81396
192.168.0.38,11289,168.126.63.2,53,UDP,2,292,1422,1,82,1,210,2541.273097,0.006179,106166,271888
192.168.0.38,26523,168.126.63.2,53,UDP,2,274,1423,1,82,1,192,2541.273136,0.006141,106822,250122
192.168.0.38,54910,121.53.105.132,443,TCP,41,11981,429,19,4390,22,7591,2541.27963,180.034362,195,337
192.168.0.38,41416,168.126.63.2,53,UDP,2,208,1424,1,79,1,129,2547.162906,0.004863,,
192.168.0.38,56968,168.126.63.2,53,UDP,2,232,1425,1,79,1,153,2547.16295,0.00482,,
192.168.0.38,60569,142.250.76.142,443,UDP,21,9439,1426,9,4238,12,5201,2547.168524,0.332119,102083,125280
192.168.0.7,52114,192.168.0.38,7000,TCP,12,2612,430,6,449,6,2163,2550.257416,0.062395,57568,277329
192.168.0.38,56419,239.255.255.250,1900,UDP,4,872,1427,4,872,0,0,2551.133294,3.022676,2307,0
192.168.0.38,6326,168.126.63.2,53,UDP,2,182,1428,1,83,1,99,2556.125021,0.005307,125117,149236
192.168.0.38,61649,168.126.63.2,53,UDP,2,226,1429,1,83,1,143,2556.125088,0.005239,126741,218362
192.168.0.38,63924,142.250.207.110,443,UDP,19,6875,1430,9,2461,10,4414,2556.131347,0.256826,76658,137493
192.168.0.38,60573,66.22.228.211,50001,UDP,35438,40325931,1431,18391,20466515,17047,19859416,2571.364767,60.001183,2728814,2647869
192.168.0.23,51392,192.168.0.38,7000,TCP,12,2613,431,6,449,6,2164,2577.996748,0.059138,60739,292739
192.168.0.38,13290,168.126.63.2,53,UDP,2,258,1432,1,85,1,173,2587.411337,0.006151,110551,225004
192.168.0.38,11819,168.126.63.2,53,UDP,2,254,1433,1,85,1,169,2587.411382,0.006106,111365,221421
192.168.0.38,54953,216.239.36.180,443,UDP,28,15890,1434,14,6674,14,9216,2587.4183,0.338688,157643,217687
192.168.0.38,68,192.168.0.1,67,UDP,2,932,1435,1,342,1,590,2588.793472,0.099577,27476,47400
192.168.0.47,55394,192.168.0.38,7000,TCP,12,2613,432,6,449,6,2164,2594.021011,0.038049,94404,454992
192.168.0.44,50645,192.168.0.38,7000,TCP,13,2679,433,6,449,7,2230,2601.120434,0.040303,89124,442646
192.168.0.38,53356,142.250.207.110,443,UDP,27,7693,1436,13,2965,14,4728,2601.690723,0.693863,34185,54512
192.168.0.38,17303,168.126.63.2,53,UDP,2,446,1437,1,91,1,355,2601.71649,0.004311,,
192.168.0.38,62457,168.126.63.2,53,UDP,2,242,1438,1,91,1,151,2601.716534,0.004267,,
192.168.0.38,57058,172.217.25.170,443,UDP,19,6895,1439,9,2465,10,4430,2601.721207,0.267322,73768,132574
192.168.0.38,14228,168.126.63.2,53,UDP,2,166,1440,1,75,1,91,2616.511119,0.00556,107913,130935
192.168.0.38,23119,168.126.63.2,53,UDP,2,210,1441,1,75,1,135,2616.51119,0.005488,109329,196793
192.168.0.38,50703,172.217.25.163,443,UDP,27,8021,1442,13,2936,14,5085,2616.517498,0.146493,160335,277692
192.168.0.38,53295,66.22.228.211,50001,UDP,35436,40323215,1443,18297,20356905,17139,19966310,2631.363582,60.037896,2712540,2660494
192.168.0.15,52345,192.168.0.38,7000,TCP,12,2613,434,6,449,6,2164,2631.693356,0.036472,98486,474665
192.168.0.23,51393,192.168.0.38,7000,TCP,13,2679,435,7,515,6,2164,2638.584294,0.072026,57201,240357
192.168.0.38,63385,172.217.25.163,443,UDP,18,7119,1444,8,2392,10,4727,2657.026199,0.129091,148236,292940
192.168.0.38,31247,168.126.63.2,53,UDP,2,437,1445,1,83,1,354,2658.274721,0.004107,,
192.168.0.38,30815,168.126.63.2,53,UDP,2,226,1446,1,83,1,143,2658.274825,0.004003,,
192.168.0.38,51393,142.250.207.110,443,UDP,19,6877,1447,9,2463,10,4414,2658.27954,0.278668,70707,126717
192.168.0.38,28316,168.126.63.2,53,UDP,2,198,1448,1,91,1,107,2662.714005,0.005046,144272,169639
192.168.0.38,14681,168.126.63.2,53,UDP,2,232,1449,1,91,1,141,2662.714043,0.005008,145367,225239
192.168.0.38,58469,172.217.161.202,443,UDP,19,6897,1450,9,2467,10,4430,2662.71946,0.271445,72707,130560
192.168.0.38,62263,239.255.255.250,1900,UDP,4,872,1451,4,872,0,0,2671.139542,3.02131,2308,0
192.168.0.57,52802,192.168.0.38,7000,TCP,13,2679,436,6,449,7,2230,2685.872488,0.058262,61652,306203
192.168.0.38,58483,66.22.228.211,50001,UDP,34987,39699638,1452,18377,20435505,16610,19264133,2691.363386,60.051024,2722418,2566368
192.168.0.51,52167,192.168.0.38,7000,TCP,12,2613,437,6,449,6,2164,2717.898164,0.050504,71123,342784
192.168.0.38,17370,168.126.63.2,53,UDP,2,164,1453,1,74,1,90,2718.087157,0.006238,94902,115421
192.168.0.38,35784,168.126.63.2,53,UDP,2,173,1454,1,74,1,99,2718.087221,0.006174,95885,128279
192.168.0.38,52253,172.217.25.164,443,UDP,38,14627,1455,18,5849,20,8778,2718.094309,0.24794,188723,283229
192.168.0.38,34422,168.126.63.2,53,UDP,2,274,1456,1,81,1,193,2718.97076,0.003571,,
192.168.0.38,19519,168.126.63.2,53,UDP,2,222,1457,1,81,1,141,2718.970812,0.003519,,
192.168.0.38,49234,172.217.25.170,443,UDP,66,43713,1458,26,5226,40,38487,2718.97528,0.435678,95960,706705
192.168.0.38,28735,168.126.63.2,53,UDP,2,437,1459,1,83,1,354,2719.127066,0.006154,107897,460188
192.168.0.38,32909,168.126.63.2,53,UDP,2,223,1460,1,83,1,140,2719.127138,0.006083,109156,184119
192.168.0.38,63386,142.250.206.206,443,UDP,41,13005,1461,19,6483,22,6522,2719.134192,29.990489,1729,1739
192.168.0.38,52317,168.126.63.2,53,UDP,2,190,1462,1,87,1,103,2720.038596,0.005431,128153,151721
192.168.0.38,25110,168.126.63.2,53,UDP,2,234,1463,1,87,1,147,2720.038636,0.00539,129128,218181
192.168.0.38,61623,142.250.76.142,443,UDP,60,45515,1464,22,3476,38,42039,2720.044545,0.17049,163106,1972620
192.168.0.7,52146,192.168.0.38,7000,TCP,12,2612,438,6,449,6,2163,2722.053226,0.049336,72806,350737
192.168.0.38,64917,168.126.63.2,53,UDP,2,166,1465,1,75,1,91,2722.38659,0.004487,,
192.168.0.38,33815,168.126.63.2,53,UDP,2,210,1466,1,75,1,135,2722.386815,0.004262,,
192.168.0.38,61686,168.126.63.2,53,UDP,2,166,1467,1,75,1,91,2722.386949,0.006452,92994,112833
192.168.0.38,32004,168.126.63.2,53,UDP,2,210,1468,1,75,1,135,2722.386999,0.006403,93706,168670
192.168.0.38,61896,142.250.207.99,443,UDP,12,5620,1469,6,1757,6,3863,2722.393832,0.142701,98499,216564
192.168.0.38,51294,142.250.206.195,443,UDP,33,8430,1470,15,3070,18,5360,2722.39775,15.551826,1579,2757
192.168.0.38,57922,168.126.63.2,53,UDP,2,446,1471,1,91,1,355,2723.982011,0.004938,,
192.168.0.38,13462,168.126.63.2,53,UDP,2,242,1472,1,91,1,151,2723.982057,0.004892,,
192.168.0.38,61717,172.217.25.170,443,UDP,19,6896,1473,9,2466,10,4430,2723.987332,0.270483,72936,131024
192.168.0.54,61272,192.168.0.38,7000,TCP,13,2679,439,6,449,7,2230,2725.394614,0.03571,100588,499579
192.168.0.38,22659,168.126.63.2,53,UDP,2,208,1474,1,79,1,129,2728.93164,0.004882,,
192.168.0.38,33307,168.126.63.2,53,UDP,2,242,1475,1,79,1,163,2728.931686,0.004835,,
192.168.0.96,54675,192.168.0.38,7000,TCP,14,4205,440,7,527,7,3678,2729.893138,0.048512,86906,606530
192.168.0.47,55404,192.168.0.38,7000,TCP,12,2613,441,6,449,6,2164,2736.258425,0.065721,54655,263416
192.168.0.96,54678,192.168.0.38,7000,TCP,12,2613,442,6,449,6,2164,2744.952468,0.037115,96780,466442
192.168.0.23,51404,192.168.0.38,7000,TCP,13,2679,443,6,449,7,2230,2746.659556,0.029857,120306,597514
192.168.0.38,55600,66.22.228.211,50001,UDP,34721,39410536,1476,18254,20280417,16467,19130119,2751.36293,60.027343,2702823,2549520
192.168.0.38,51533,168.126.63.1,53,UDP,2,344,1477,1,75,1,269,2762.240623,0.005781,103788,372253
192.168.0.38,58541,168.126.63.1,53,UDP,2,284,1478,1,75,1,209,2762.240714,0.005689,105466,293900
192.168.0.38,56152,168.126.63.1,53,UDP,2,288,1479,1,106,1,182,2762.247111,0.003847,,
192.168.0.38,54310,52.177.138.113,443,TCP,26,8774,444,12,2384,14,6390,2762.252425,31.174952,611,1639
fe80::102a:21ec:c118:a887,5353,fe80::c53:5394:9cfd:8d70,5353,UDP,2,607,1480,1,265,1,342,2764.731862,2240.374449,0,1
192.168.0.42,59919,192.168.0.38,7000,TCP,14,4205,445,7,527,7,3678,2765.334969,0.061592,68450,477724
192.168.0.38,37544,168.126.63.2,53,UDP,2,154,1481,1,69,1,85,2765.512,0.004617,,
192.168.0.38,57690,168.126.63.2,53,UDP,2,203,1482,1,69,1,134,2765.512071,0.004546,,
192.168.0.38,54911,192.0.77.2,443,TCP,27,4471,446,14,2022,13,2449,2765.51688,75.25691,214,260
192.168.0.38,55844,172.217.25.164,443,UDP,67,39780,1483,27,6115,40,33665,2767.785076,0.405374,120678,664374
192.168.0.38,59617,142.250.207.99,443,UDP,12,5621,1484,6,1758,6,3863,2772.024238,0.126317,111338,244654
192.168.0.38,62735,142.250.206.195,443,UDP,12,5615,1485,6,1752,6,3863,2772.024566,0.142621,98274,216686
192.168.0.96,54680,192.168.0.38,7000,TCP,13,2679,447,6,449,7,2230,2777.876127,0.038257,93891,466319
192.168.0.38,60704,142.250.206.206,443,UDP,33,13433,1486,15,7407,18,6026,2778.632878,17.620942,3362,2735
192.168.0.38,41421,168.126.63.2,53,UDP,2,437,1487,1,83,1,354,2779.958124,0.004493,,
192.168.0.38,22978,168.126.63.2,53,UDP,2,223,1488,1,83,1,140,2779.958168,0.004447,,
192.168.0.38,55483,142.250.207.110,443,UDP,19,6868,1489,9,2454,10,4414,2779.963296,0.25019,78468,141140
192.168.0.38,26146,168.126.63.2,53,UDP,2,206,1490,1,95,1,111,2780.829804,0.004756,,
192.168.0.38,27463,168.126.63.2,53,UDP,2,250,1491,1,95,1,155,2780.829851,0.004709,,
192.168.0.38,65001,172.217.25.174,443,UDP,115,31146,1492,55,11367,60,19779,2780.835061,4.207571,21612,37606
192.168.0.38,16021,168.126.63.2,53,UDP,2,446,1493,1,91,1,355,2785.554658,0.004261,,
192.168.0.38,64899,168.126.63.2,53,UDP,2,232,1494,1,91,1,141,2785.554707,0.004212,,
192.168.0.38,57055,142.250.207.106,443,UDP,19,6896,1495,9,2466,10,4430,2785.559347,0.265891,74195,133287
192.168.0.38,59064,168.126.63.2,53,UDP,2,254,1496,1,71,1,183,2786.769655,0.005386,105458,271815
192.168.0.38,13638,168.126.63.2,53,UDP,2,202,1497,1,71,1,131,2786.769704,0.005338,106406,196328
192.168.0.38,50884,172.217.161.246,443,UDP,1012,1067510,1498,171,18447,841,1049063,2786.776213,2.421578,60942,3465716
192.168.0.38,33188,168.126.63.2,53,UDP,2,210,1499,1,73,1,137,2787.329763,0.005233,111599,209440
192.168.0.38,27600,168.126.63.2,53,UDP,2,254,1500,1,73,1,181,2787.329839,0.005157,113244,280783
192.168.0.38,63138,172.217.25.161,443,UDP,52,26956,1501,24,4797,28,22159,2787.335571,0.16021,239535,1106497
192.168.0.96,54682,192.168.0.38,7000,TCP,13,2679,448,6,449,7,2230,2790.019519,0.069628,51588,256218
192.168.0.38,56829,239.255.255.250,1900,UDP,4,872,1502,4,872,0,0,2791.144094,3.022973,2307,0
192.168.0.96,54684,192.168.0.38,7000,TCP,15,4271,449,8,593,7,3678,2794.666124,0.050224,94456,585855
192.168.0.7,52152,192.168.0.38,7000,TCP,12,2612,450,6,449,6,2163,2795.934402,0.043301,82954,399621
192.168.0.96,54686,192.168.0.38,7000,TCP,15,4271,451,7,527,8,3744,2798.435605,0.06048,69708,495238
192.168.0.38,53783,66.22.228.211,50001,UDP,35461,40310315,1503,18413,20494853,17048,19815462,2811.36164,60.01412,2732004,2641439
192.168.0.96,54688,192.168.0.38,7000,TCP,15,4271,452,7,527,8,3744,2819.900654,0.040129,105061,746392
192.168.0.38,45842,168.126.63.2,53,UDP,2,208,1504,1,79,1,129,2847.17224,0.007606,83092,135682
192.168.0.38,5827,168.126.63.2,53,UDP,2,232,1505,1,79,1,153,2847.172341,0.007506,84199,163069
192.168.0.38,48257,168.126.63.2,53,UDP,2,198,1506,1,91,1,107,2847.176791,0.004513,,
192.168.0.38,59217,168.126.63.2,53,UDP,2,242,1507,1,91,1,151,2847.176855,0.004449,,
192.168.0.38,58056,142.250.206.238,443,UDP,20,9399,1508,10,4132,10,5267,2847.180287,0.338786,97571,124373
192.168.0.38,53128,172.217.161.202,443,UDP,19,6894,1509,9,2464,10,4430,2847.181899,0.269843,73049,131335
192.168.0.22,5353,224.0.0.251,5353,UDP,5,515,1510,5,515,0,0,2848.566157,42.086397,97,0
192.168.0.96,54690,192.168.0.38,7000,TCP,12,2613,453,6,449,6,2164,2855.224866,0.051053,70358,339098
192.168.0.38,43977,168.126.63.2,53,UDP,2,166,1511,1,75,1,91,2858.877412,0.005604,107066,129907
192.168.0.38,32954,168.126.63.2,53,UDP,2,210,1512,1,75,1,135,2858.877501,0.005516,108774,195794
192.168.0.38,55715,142.250.207.99,443,UDP,29,8175,1513,14,3017,15,5158,2858.8838,0.25856,93347,159591
fe80::102a:21ec:c118:a887,5353,fe80::804:6484:7cc3:9ef6,5353,UDP,2,770,1514,1,459,1,311,2859.674561,2145.423686,1,1
192.168.0.38,50726,168.126.63.1,53,UDP,2,344,1515,1,104,1,240,2870.804197,0.005243,158687,366202
192.168.0.38,64697,168.126.63.1,53,UDP,2,284,1516,1,104,1,180,2870.804347,0.005092,163393,282796
192.168.0.38,56830,168.126.63.1,53,UDP,2,288,1517,1,106,1,182,2870.810063,0.006112,138743,238219
192.168.0.38,54311,40.70.161.7,443,TCP,26,8774,454,12,2384,14,6390,2870.818647,64.469133,295,792
192.168.0.38,60422,66.22.228.211,50001,UDP,35494,40348745,1518,18416,20481533,17078,19867212,2871.360376,60.013055,2730277,2648385
192.168.0.96,54692,192.168.0.38,7000,TCP,12,2613,455,6,449,6,2164,2873.615374,0.048375,74253,357870
192.168.0.7,52162,192.168.0.38,7000,TCP,12,2612,456,6,449,6,2163,2876.877344,0.034166,105133,506468
192.168.0.38,56719,142.250.206.238,443,UDP,22,9597,1519,11,4209,11,5388,2878.393241,0.377,89315,114334
192.168.0.23,51407,192.168.0.38,7000,TCP,12,2613,457,6,449,6,2164,2883.108066,0.065857,54542,262872
192.168.0.38,32966,168.126.63.2,53,UDP,2,506,1520,1,85,1,421,2885.262165,0.004738,,
192.168.0.38,7081,168.126.63.2,53,UDP,2,244,1521,1,85,1,159,2885.262289,0.004613,,
192.168.0.38,54554,216.239.36.180,443,UDP,20,8432,1522,10,3583,10,4849,2885.267435,0.267307,107232,145121
192.168.0.38,55093,172.217.161.202,443,UDP,27,7752,1523,13,2990,14,4762,2885.906504,0.681386,35104,55909
192.168.0.38,15992,168.126.63.2,53,UDP,2,168,1524,1,76,1,92,2887.792319,0.005449,111580,135070
192.168.0.38,36911,168.126.63.2,53,UDP,2,202,1525,1,76,1,126,2887.792372,0.005397,112655,186770
192.168.0.38,54301,172.217.161.206,443,UDP,25,12393,1526,12,6849,13,5544,2887.798581,0.348642,157158,127213
192.168.0.38,1851,168.126.63.2,53,UDP,2,370,1527,1,89,1,281,2890.957146,0.004176,,
192.168.0.38,28911,168.126.63.2,53,UDP,2,238,1528,1,89,1,149,2890.957245,0.004077,,
192.168.0.38,12713,168.126.63.2,53,UDP,2,446,1529,1,79,1,367,2893.905953,0.005457,115814,538024
192.168.0.38,16445,168.126.63.2,53,UDP,2,242,1530,1,79,1,163,2893.90607,0.005341,118329,244149
192.168.0.38,58644,172.217.25.174,443,UDP,21,8883,1531,9,3780,12,5103,2893.912407,0.313627,96420,130167
192.168.0.38,58856,142.250.207.99,443,UDP,20,7271,1532,10,2543,10,4728,2899.069867,0.254059,80075,148878
192.168.0.35,49186,192.168.0.38,7000,TCP,12,2613,458,6,449,6,2164,2908.387341,0.061194,58698,282903
192.168.0.3,49547,192.168.0.38,7000,TCP,13,2678,459,6,449,7,2229,2908.567463,0.077391,46413,230414
192.168.0.38,57221,168.126.63.2,53,UDP,2,208,1533,1,79,1,129,2909.263292,0.004434,,
192.168.0.38,1616,168.126.63.2,53,UDP,2,242,1534,1,79,1,163,2909.263382,0.004345,,
192.168.0.38,58981,172.217.25.174,443,UDP,20,9452,1535,10,4133,10,5319,2909.268318,0.319064,103628,133365
192.168.0.7,52165,192.168.0.38,7000,TCP,12,2612,460,6,449,6,2163,2910.235316,0.065498,54841,264191
192.168.0.43,49213,192.168.0.38,7000,TCP,12,2613,461,6,449,6,2164,2910.596883,0.031263,114896,553753
192.168.0.38,52695,239.255.255.250,1900,UDP,4,872,1536,4,872,0,0,2911.149921,3.022254,2308,0
192.168.0.50,52573,192.168.0.38,7000,TCP,12,2613,462,6,449,6,2164,2912.641767,0.022869,157068,757007
192.168.0.63,50272,192.168.0.38,7000,TCP,12,2613,463,6,449,6,2164,2912.657508,0.026319,136479,657775
192.168.0.23,51410,192.168.0.38,7000,TCP,12,2613,464,6,449,6,2164,2916.34173,0.045446,79038,380935
192.168.0.54,61299,192.168.0.38,7000,TCP,12,2613,465,6,449,6,2164,2918.215494,0.040498,88695,427477
192.168.0.38,53835,66.22.228.211,50001,UDP,35611,40516500,1537,18279,20320723,17332,20195777,2931.360156,60.015926,2708710,2692055
192.168.0.38,59540,172.217.25.174,443,UDP,22,9638,1538,11,4203,11,5435,2940.261457,0.375753,89484,115714
192.168.0.38,60711,168.126.63.2,53,UDP,2,198,1539,1,91,1,107,2947.062167,0.004421,,
192.168.0.38,47181,168.126.63.2,53,UDP,2,242,1540,1,91,1,151,2947.06221,0.004377,,
192.168.0.38,57769,142.250.76.138,443,UDP,19,6895,1541,9,2465,10,4430,2947.066958,0.275183,71661,128787
192.168.0.38,65330,172.217.161.206,443,UDP,25,12477,1542,12,6846,13,5631,2947.789716,0.346359,158124,130061
192.168.0.38,57516,172.217.25.174,443,UDP,20,9264,1543,10,4132,10,5132,2971.259822,0.320621,103099,128051
192.168.0.38,36207,168.126.63.2,53,UDP,2,421,1544,1,75,1,346,2979.007457,0.005068,118389,546172
192.168.0.38,54087,168.126.63.2,53,UDP,2,207,1545,1,75,1,132,2979.00752,0.005005,119880,210989
192.168.0.38,57589,142.250.76.131,443,UDP,31,8312,1546,14,3012,17,5300,2979.013187,0.216917,111083,195466
192.168.0.38,56334,66.22.228.211,50001,UDP,34852,39561514,1547,18115,20119163,16737,19442351,2991.359444,60.003662,2682391,2592155
192.168.0.38,59598,172.217.25.174,443,UDP,22,9466,1548,11,4203,11,5263,3002.256297,0.470621,71446,89464
192.168.0.38,3628,168.126.63.2,53,UDP,2,168,1549,1,76,1,92,3008.000017,0.004517,,
192.168.0.38,39758,168.126.63.2,53,UDP,2,202,1550,1,76,1,126,3008.000059,0.004476,,
192.168.0.38,60767,142.250.76.142,443,UDP,25,13214,1551,12,7574,13,5640,3008.005002,0.358546,168993,125841
192.168.0.15,52346,192.168.0.38,7000,TCP,12,2613,466,6,449,6,2164,3008.585302,0.034099,105340,507698
192.168.0.38,59234,168.126.63.2,53,UDP,2,198,1552,1,91,1,107,3008.718372,0.012094,60195,70778
192.168.0.38,13359,168.126.63.2,53,UDP,2,232,1553,1,91,1,141,3008.718434,0.004716,,
192.168.0.38,53791,142.250.206.202,443,UDP,19,6895,1554,9,2465,10,4430,3008.731072,0.259969,75855,136323
192.168.0.28,60326,192.168.0.38,7000,TCP,12,2613,467,6,449,6,2164,3020.697981,0.032647,110025,530278
192.168.0.38,61330,239.255.255.250,1900,UDP,4,872,1555,4,872,0,0,3031.155621,3.022538,2307,0
192.168.0.38,42205,168.126.63.2,53,UDP,2,198,1556,1,79,1,119,3033.256125,0.006095,103691,156193
192.168.0.38,19090,168.126.63.2,53,UDP,2,242,1557,1,79,1,163,3033.256149,0.00607,104118,214827
192.168.0.38,49340,172.217.25.174,443,UDP,20,9557,1558,10,4127,10,5430,3033.262607,0.347653,94968,124952
192.168.0.50,52576,192.168.0.38,7000,TCP,13,2679,468,6,449,7,2230,3033.949827,0.109862,32695,162385
192.168.0.96,54695,192.168.0.38,7000,TCP,15,4271,469,7,527,8,3744,3035.873923,0.054815,76913,546419
192.168.0.28,60327,192.168.0.38,7000,TCP,15,4271,470,7,527,8,3744,3037.70033,0.067523,62437,443582
192.168.0.47,55414,192.168.0.38,7000,TCP,12,2613,471,6,449,6,2164,3044.62298,0.038771,92646,446519
192.168.0.38,54660,66.22.228.211,50001,UDP,35014,39761023,1559,18332,20398013,16682,19363010,3051.357721,60.016034,2719008,2581044
192.168.0.7,52168,192.168.0.38,7000,TCP,12,2612,472,6,449,6,2163,3052.646098,0.039373,91230,439488
192.168.0.38,63031,172.217.25.174,443,UDP,20,9364,1560,10,4135,10,5229,3064.257509,0.335951,98466,124518
192.168.0.38,52472,168.126.63.1,53,UDP,2,249,1561,1,76,1,173,3065.654062,0.00533,114071,259662
192.168.0.38,52616,168.126.63.1,53,UDP,2,207,1562,1,76,1,131,3065.654339,0.005054,120300,207360
192.168.0.38,49570,168.126.63.1,53,UDP,2,237,1563,1,85,1,152,3065.660086,0.004525,,
192.168.0.38,54312,211.249.201.68,443,TCP,30,12638,473,15,2790,15,9848,3065.666135,60.648653,368,1299
192.168.0.54,61319,192.168.0.38,7000,TCP,20,8745,474,9,671,11,8074,3066.271859,1.605799,3342,40224
192.168.0.38,31946,168.126.63.2,53,UDP,2,198,1564,1,91,1,107,3070.03907,0.005014,145193,170721
192.168.0.38,44419,168.126.63.2,53,UDP,2,242,1565,1,91,1,151,3070.03912,0.004964,,
192.168.0.38,60960,172.217.25.170,443,UDP,19,6893,1566,9,2463,10,4430,3070.044499,0.269266,73176,131617
192.168.0.38,61745,172.217.25.174,443,UDP,20,9448,1567,10,4131,10,5317,3095.258259,0.335208,98589,126894
192.168.0.38,41092,168.126.63.2,53,UDP,2,166,1568,1,75,1,91,3099.137392,0.006145,97640,118470
192.168.0.38,37364,168.126.63.2,53,UDP,2,210,1569,1,75,1,135,3099.137503,0.006033,99453,179015
192.168.0.38,64222,142.250.76.131,443,UDP,28,8097,1570,13,2943,15,5154,3099.144774,0.177828,132397,231864
192.168.0.38,61083,66.22.228.211,50001,UDP,11753,13334498,1571,6056,6722685,5697,6611813,3111.357394,20.560026,2615827,2572686
192.168.0.38,37513,168.126.63.2,53,UDP,2,168,1572,1,76,1,92,3122.50044,0.006002,101299,122625
192.168.0.38,6719,168.126.63.2,53,UDP,2,202,1573,1,76,1,126,3122.500497,0.005945,102270,169554
192.168.0.38,49421,172.217.161.238,443,UDP,23,12361,1574,12,6848,11,5513,3122.506883,0.357008,153453,123537
192.168.0.38,59171,168.126.63.2,53,UDP,2,208,1575,1,79,1,129,3126.261829,0.00546,115750,189010
192.168.0.38,63330,168.126.63.2,53,UDP,2,242,1576,1,79,1,163,3126.261879,0.005409,116842,241079
192.168.0.38,64639,142.250.206.206,443,UDP,20,9314,1577,10,4133,10,5181,3126.267713,0.350236,94404,118343
192.168.0.38,53835,168.126.63.2,53,UDP,2,198,1578,1,91,1,107,3131.747615,0.005628,129353,152096
192.168.0.38,34427,168.126.63.2,53,UDP,2,242,1579,1,91,1,151,3131.747757,0.005487,132677,220156
192.168.0.38,63414,142.250.76.138,443,UDP,27,8179,1580,13,3125,14,5054,3131.753987,25.024561,999,1615
192.168.0.38,56294,168.126.63.1,53,UDP,2,197,1581,1,71,1,126,3134.197586,0.005428,104642,185703
192.168.0.38,57195,168.126.63.1,53,UDP,2,222,1582,1,71,1,151,3134.197684,0.005331,106546,226599
192.168.0.38,54313,162.159.128.233,443,TCP,14,5938,475,8,1555,6,4383,3134.207982,6.53586,1903,5364
192.168.0.38,49164,162.159.136.232,443,UDP,60,35537,1583,24,5994,36,29543,3134.591716,6.113976,7843,38656
192.168.0.38,54912,162.159.136.232,443,TCP,14,3993,476,8,1121,6,2872,3134.601773,6.111048,1467,3759
192.168.0.38,57791,168.126.63.1,53,UDP,2,236,1584,1,78,1,158,3134.854085,0.004988,,
192.168.0.38,54913,162.159.133.234,443,TCP,20,5890,477,11,1947,9,3943,3134.863119,5.845249,2664,5396
192.168.0.28,60329,192.168.0.38,7000,TCP,17,2979,478,8,593,9,2386,3141.330174,1.322432,3587,14434
192.168.0.38,60113,168.126.63.1,53,UDP,2,264,1585,1,76,1,188,3143.616406,0.00509,119449,295481
192.168.0.38,51637,168.126.63.1,53,UDP,2,316,1586,1,76,1,240,3143.616516,0.004981,,
192.168.0.38,65113,168.126.63.1,53,UDP,2,240,1587,1,82,1,158,3143.623347,0.004689,,
192.168.0.38,54314,17.248.221.9,443,TCP,37,19768,479,17,6716,20,13052,3143.645832,46.938376,1144,2224
192.168.0.38,64405,168.126.63.1,53,UDP,2,240,1588,1,82,1,158,3143.685354,0.005808,112947,217630
192.168.0.38,59177,168.126.63.1,53,UDP,2,292,1589,1,82,1,210,3143.685517,0.005642,116270,297766
192.168.0.38,54315,17.248.221.1,443,TCP,26,10639,480,12,2783,14,7856,3143.700043,47.222747,471,1330
192.168.0.38,49175,168.126.63.1,53,UDP,2,248,1590,1,86,1,162,3143.775151,0.004849,,
192.168.0.38,54833,168.126.63.1,53,UDP,2,300,1591,1,86,1,214,3143.775431,0.004569,,
192.168.0.38,54316,17.248.221.11,443,TCP,38,17794,481,18,7533,20,10261,3143.785625,46.954645,1283,1748
192.168.0.38,59934,168.126.63.1,53,UDP,2,254,1592,1,89,1,165,3144.019469,0.004878,,
192.168.0.38,51918,168.126.63.1,53,UDP,2,306,1593,1,89,1,217,3144.019583,0.004763,,
192.168.0.38,54317,17.248.221.9,443,TCP,44,28106,482,17,5457,27,22649,3144.023305,47.173084,925,3841
192.168.0.38,54318,17.248.221.5,443,TCP,25,11661,483,11,2592,14,9069,3144.027627,47.171329,439,1538
192.168.0.38,56129,168.126.63.1,53,UDP,2,244,1594,1,84,1,160,3144.134654,0.00557,120646,229802
192.168.0.38,49184,168.126.63.1,53,UDP,2,296,1595,1,84,1,212,3144.134782,0.005441,123506,311707
192.168.0.38,54319,17.248.221.11,443,TCP,39,13907,484,17,4176,22,9731,3144.151752,3.070697,10879,25351
192.168.0.38,54320,17.248.221.9,443,TCP,32,16147,485,13,3522,19,12625,3144.248242,47.244943,596,2137
192.168.0.38,54321,17.248.221.2,443,TCP,37,22677,486,15,4083,22,18594,3144.354519,46.840356,697,3175
192.168.0.38,54322,17.248.221.2,443,TCP,28,15183,487,11,2593,17,12590,3144.589881,46.606509,445,2161
192.168.0.38,54323,17.248.221.2,443,TCP,29,15249,488,12,2659,17,12590,3144.654863,46.542466,457,2164
192.168.0.38,54324,17.248.221.9,443,TCP,50,26060,489,23,9502,27,16558,3144.68216,46.365942,1639,2856
192.168.0.38,54092,168.126.63.1,53,UDP,2,265,1596,1,73,1,192,3144.844121,0.003741,,
192.168.0.38,62296,168.126.63.1,53,UDP,2,221,1597,1,73,1,148,3144.844265,0.003596,,
192.168.0.38,53283,168.126.63.1,53,UDP,2,254,1598,1,89,1,165,3144.848527,0.005738,124085,230045
192.168.0.38,54325,17.32.194.34,443,TCP,26,11498,490,13,4056,13,7442,3144.856595,35.299057,919,1686
192.168.0.38,54326,17.248.221.9,443,TCP,30,13701,491,13,3592,17,10109,3145.186347,45.866148,626,1763
192.168.0.38,64699,168.126.63.1,53,UDP,2,284,1599,1,92,1,192,3145.351042,0.079775,9225,19254
192.168.0.38,55349,168.126.63.1,53,UDP,2,224,1600,1,92,1,132,3145.351149,0.076885,9572,13734
192.168.0.38,54327,17.42.251.13,443,TCP,26,13160,492,14,3977,12,9183,3145.407205,45.924989,692,1599
192.168.0.38,61657,168.126.63.1,53,UDP,2,258,1601,1,91,1,167,3145.431218,0.003641,,
192.168.0.38,54328,17.248.221.11,443,TCP,39,13643,493,17,4125,22,9518,3145.956382,2.55149,12933,29842
192.168.0.38,54283,168.126.63.1,53,UDP,2,252,1602,1,96,1,156,3147.076264,0.004415,,
192.168.0.38,64906,168.126.63.1,53,UDP,2,208,1603,1,96,1,112,3147.076365,0.004315,,
192.168.0.38,58699,142.250.206.193,443,UDP,35,18800,1604,18,6148,17,12652,3147.100798,0.645929,76144,156698
192.168.0.38,59272,142.250.206.193,443,UDP,31,16242,1605,16,5118,15,11124,3147.732682,0.565937,72347,157247
192.168.0.38,56096,142.250.206.193,443,UDP,37,18858,1606,18,5450,19,13408,3148.303196,0.639037,68227,167852
192.168.0.38,58052,142.250.206.193,443,UDP,35,17792,1607,18,5636,17,12156,3148.918946,0.646307,69762,150467
192.168.0.38,62864,142.250.206.193,443,UDP,35,18974,1608,17,5563,18,13411,3149.545392,0.762474,58367,140710
192.168.0.38,49347,142.250.206.193,443,UDP,44,30323,1609,18,7557,26,22766,3150.291988,0.834477,72447,218254
192.168.0.38,49406,239.255.255.250,1900,UDP,4,872,1610,4,872,0,0,3151.161701,3.014031,2314,0
192.168.0.38,54915,192.168.0.7,7000,TCP,12,2539,494,6,449,6,2090,3153.132315,0.050967,70476,328055
192.168.0.38,56025,168.126.63.1,53,UDP,2,305,1611,1,80,1,225,3153.910721,0.005053,126657,356224
192.168.0.38,52547,168.126.63.1,53,UDP,2,245,1612,1,80,1,165,3153.910905,0.004868,,
192.168.0.38,61532,168.126.63.1,53,UDP,2,258,1613,1,91,1,167,3153.917519,0.004906,,
192.168.0.38,54329,17.56.10.43,443,TCP,28,9733,495,13,3144,15,6589,3153.95027,1070.642916,23,49
192.168.0.38,51865,168.126.63.1,53,UDP,2,174,1614,1,79,1,95,3154.150492,0.004235,,
192.168.0.38,65384,168.126.63.1,53,UDP,2,164,1615,1,74,1,90,3154.150939,0.004969,,
192.168.0.38,59513,168.126.63.1,53,UDP,2,203,1616,1,75,1,128,3154.151168,0.003559,,
192.168.0.38,58048,168.126.63.1,53,UDP,2,318,1617,1,95,1,223,3154.151518,0.005985,126984,298078
192.168.0.38,62383,168.126.63.1,53,UDP,2,302,1618,1,73,1,229,3154.15152,0.005982,97626,306252
192.168.0.38,55391,168.126.63.1,53,UDP,2,362,1619,1,103,1,259,3154.152248,0.005255,156803,394291
192.168.0.38,56355,168.126.63.1,53,UDP,2,361,1620,1,95,1,266,3154.15271,0.004793,,
192.168.0.38,27363,168.126.63.2,53,UDP,2,258,1621,1,85,1,173,3155.276785,0.006548,103848,211362
192.168.0.38,60017,168.126.63.2,53,UDP,2,244,1622,1,85,1,159,3155.276885,0.006449,105442,197239
192.168.0.38,62110,216.239.32.180,443,UDP,36,21107,1623,15,4009,21,17098,3155.284866,0.305664,104925,447497
192.168.0.38,28881,168.126.63.2,53,UDP,2,164,1624,1,74,1,90,3155.590062,0.004233,,
192.168.0.38,16291,168.126.63.2,53,UDP,2,173,1625,1,74,1,99,3155.590128,0.004166,,
192.168.0.38,63277,142.250.206.196,443,UDP,80,52612,1626,32,6172,48,46440,3155.595076,1.068463,46212,347714
192.168.0.38,58799,168.126.63.2,53,UDP,2,197,1627,1,76,1,121,3155.758625,0.006692,90854,144650
192.168.0.38,54921,108.177.97.188,5228,TCP,24,9772,496,11,1517,13,8255,3155.770438,61.199676,198,1079
192.168.0.38,57269,168.126.63.1,53,UDP,2,242,1628,1,79,1,163,3155.800053,0.005556,113750,234701
192.168.0.38,123,17.253.68.253,123,UDP,2,180,1629,1,90,1,90,3155.838682,0.145211,4958,4958
192.168.0.38,62769,168.126.63.2,53,UDP,2,549,1630,1,91,1,458,3156.628487,0.004807,,
192.168.0.38,49509,168.126.63.2,53,UDP,2,239,1631,1,91,1,148,3156.628555,0.004739,,
192.168.0.38,54330,17.248.221.13,443,TCP,71,25971,497,32,10127,39,15844,3156.705104,5.170348,15669,24515
192.168.0.38,55022,142.250.206.206,443,UDP,30,11487,1632,15,5010,15,6477,3157.252766,3.751499,10683,13812
192.168.0.38,56570,142.250.206.206,443,UDP,19,7070,1633,9,2527,10,4543,3160.25591,0.255736,79050,142115
fe80::186b:ee65:7a83:72e5,62777,fe80::102a:21ec:c118:a887,54543,TCP,4,344,498,2,196,2,148,3161.389524,1.03515,1514,1143
192.168.0.36,62778,192.168.0.38,54543,TCP,4,264,499,2,156,2,108,3161.511997,0.294752,4234,2931
192.168.0.38,50378,168.126.63.1,53,UDP,2,270,1634,1,100,1,170,3177.967995,0.004362,,
192.168.0.38,61544,17.253.114.253,123,UDP,2,180,1635,1,90,1,90,3177.967998,0.005986,120280,120280
192.168.0.50,52598,192.168.0.38,7000,TCP,12,2613,500,6,449,6,2164,3177.97143,0.042145,85229,410772
192.168.0.38,65018,17.253.114.253,123,UDP,2,180,1636,1,90,1,90,3177.976425,0.004204,,
192.168.0.38,53715,17.253.68.253,123,UDP,2,180,1637,1,90,1,90,3177.983221,0.145708,4941,4941
192.168.0.38,50009,168.126.63.1,53,UDP,2,296,1638,1,84,1,212,3178.028699,0.005154,130384,329064
192.168.0.38,54331,17.248.221.5,443,TCP,145,56431,501,61,21265,84,35166,3178.03796,36.628187,4644,7680
192.168.0.38,52175,17.253.114.253,123,UDP,2,180,1639,1,90,1,90,3180.087523,0.005344,134730,134730
192.168.0.38,52539,17.253.114.253,123,UDP,2,180,1640,1,90,1,90,3180.094949,0.007104,101351,101351
192.168.0.43,49214,192.168.0.38,7000,TCP,12,2613,502,6,449,6,2164,3180.104415,0.029488,121812,587086
192.168.0.38,60312,17.253.68.253,123,UDP,2,180,1641,1,90,1,90,3180.134235,0.13942,5164,5164
192.168.0.3,49548,192.168.0.38,7000,TCP,12,2612,503,6,449,6,2163,3180.790338,0.048619,73880,355910
192.168.0.38,60026,168.126.63.1,53,UDP,2,382,1642,1,72,1,310,3181.210246,0.006272,91836,395408
192.168.0.38,58189,168.126.63.1,53,UDP,2,320,1643,1,72,1,248,3181.21031,0.006208,92783,319587
192.168.0.38,64334,168.126.63.1,53,UDP,2,250,1644,1,86,1,164,3181.217133,0.005592,123032,234620
192.168.0.38,54332,104.91.73.144,443,TCP,20,8250,504,10,1641,10,6609,3181.224085,10.594124,1239,4990
192.168.0.35,49187,192.168.0.38,7000,TCP,12,2613,505,6,449,6,2164,3181.233378,0.038002,94521,455554
192.168.0.38,52255,168.126.63.1,53,UDP,2,376,1645,1,82,1,294,3181.336631,0.005885,111469,399660
192.168.0.38,59355,168.126.63.1,53,UDP,2,443,1646,1,82,1,361,3181.336795,0.005722,114645,504718
192.168.0.38,51433,168.126.63.1,53,UDP,2,245,1647,1,84,1,161,3181.343364,0.008904,75471,144654
192.168.0.38,54333,175.207.14.65,443,TCP,22,12393,506,9,1895,13,10498,3181.353585,10.464542,1448,8025
192.168.0.50,5353,192.168.0.38,5353,UDP,2,560,1648,2,560,0,0,3181.554549,1044.418843,4,0
192.168.0.62,5353,192.168.0.38,5353,UDP,2,528,1649,2,528,0,0,3181.571258,1044.429975,4,0
192.168.0.7,5353,192.168.0.38,5353,UDP,2,1900,1650,2,1900,0,0,3181.587325,1044.643983,14,0
192.168.0.43,5353,192.168.0.38,5353,UDP,2,622,1651,2,622,0,0,3181.668868,1044.509027,4,0
192.168.0.17,5353,192.168.0.38,5353,UDP,1,307,1652,1,307,0,0,3181.729608,0,,
fe80::10ea:5b59:7fe5:b963,5353,fe80::102a:21ec:c118:a887,5353,UDP,2,662,1653,2,662,0,0,3181.732193,1823.339636,2,0
192.168.0.63,50273,192.168.0.38,7000,TCP,12,2613,507,6,449,6,2164,3191.653528,0.043496,82582,398013
192.168.0.38,58932,168.126.63.1,53,UDP,2,241,1654,1,78,1,163,3192.521241,0.008617,72414,151328
192.168.0.38,61679,168.126.63.1,53,UDP,2,284,1655,1,78,1,206,3192.521461,0.008398,74303,196237
192.168.0.38,54334,35.165.186.1,443,TCP,135,118564,508,85,109512,50,9052,3192.533553,1032.071821,848,70
192.168.0.38,59174,172.217.161.238,443,UDP,25,13756,1656,13,7970,12,5786,3193.259267,0.355496,179355,130206
192.168.0.38,60342,142.250.76.138,443,UDP,17,6775,1657,7,2345,10,4430,3195.917593,0.267292,70185,132589
192.168.0.51,52170,192.168.0.38,7000,TCP,12,2613,509,6,449,6,2164,3195.971356,0.046709,76901,370635
192.168.0.38,53648,142.250.76.138,443,UDP,66,11640,1658,33,5537,33,6103,3196.149638,1031.905643,42,47
192.168.0.38,55094,216.239.32.180,443,UDP,21,8493,1659,10,3574,11,4919,3201.165468,0.276332,103469,142408
192.168.0.54,61323,192.168.0.38,7000,TCP,15,4271,510,8,593,7,3678,3203.998997,0.078122,60725,376641
192.168.0.38,52079,142.250.206.206,443,UDP,19,7127,1660,9,2484,10,4643,3204.179063,0.26484,75033,140250
192.168.0.38,58370,142.250.206.206,443,UDP,40,14629,1661,20,7659,20,6970,3204.407121,11.531325,5313,4835
192.168.0.38,36599,168.126.63.2,53,UDP,2,166,1662,1,75,1,91,3214.930942,0.005427,110558,134144
192.168.0.38,10829,168.126.63.2,53,UDP,2,207,1663,1,75,1,132,3214.930975,0.006716,89338,157236
192.168.0.38,55687,142.250.76.131,443,UDP,18,7121,1664,8,2393,10,4728,3214.93802,0.142864,134001,264755
192.168.0.47,55425,192.168.0.38,7000,TCP,12,2613,511,6,449,6,2164,3218.407232,0.177902,20190,97312
192.168.0.96,54701,192.168.0.38,7000,TCP,12,2613,512,6,449,6,2164,3218.725794,0.031887,112647,542917
192.168.0.38,62302,168.126.63.1,53,UDP,2,186,1665,1,85,1,101,3220.424935,0.004678,,
192.168.0.38,54335,211.249.201.68,443,TCP,36,30119,513,24,24761,12,5358,3220.434568,0.071251,2780143,601591
192.168.0.7,52176,192.168.0.38,7000,TCP,12,2612,514,6,449,6,2163,3223.454815,0.045027,79774,384302
192.168.0.42,59930,192.168.0.38,7000,TCP,12,2613,515,6,449,6,2164,4224.345598,0.282156,12730,61356
192.168.0.43,49216,192.168.0.38,7000,TCP,12,2613,516,6,449,6,2164,4224.345598,0.039598,90711,437193
192.168.0.38,49199,168.126.63.1,53,UDP,2,200,1666,1,100,1,100,4224.345691,0.00601,133111,133111
192.168.0.38,57418,168.126.63.1,53,UDP,2,236,1667,1,78,1,158,4224.345696,0.006004,103930,210526
192.168.0.38,64803,168.126.63.1,53,UDP,2,212,1668,1,82,1,130,4224.345699,0.006002,109296,173275
192.168.0.38,50973,168.126.63.1,53,UDP,2,267,1669,1,75,1,192,4224.345714,0.005984,100267,256684
192.168.0.38,55537,168.126.63.1,53,UDP,2,278,1670,1,75,1,203,4224.345718,0.005982,100300,271481
192.168.0.38,57439,168.126.63.2,53,UDP,3,300,1671,3,300,0,0,4224.352321,3.207069,748,0
192.168.0.38,49338,168.126.63.1,53,UDP,2,241,1672,1,78,1,163,4224.352537,0.005873,106248,222033
192.168.0.38,59603,17.253.114.253,123,UDP,2,180,1673,1,90,1,90,4224.353439,0.004973,,
192.168.0.38,50919,17.253.114.253,123,UDP,2,180,1674,1,90,1,90,4224.360065,0.006914,104136,104136
192.168.0.38,49665,17.253.68.123,123,UDP,2,180,1675,1,90,1,90,4224.371045,0.043472,16562,16562
192.168.0.15,52357,192.168.0.38,7000,TCP,12,2613,517,6,449,6,2164,4224.378215,0.027882,128828,620902
192.168.0.38,60847,17.248.161.70,443,UDP,23,9291,1676,13,5659,10,3632,4224.379529,0.249308,181590,116546
192.168.0.38,54315,17.253.114.253,123,UDP,2,180,1677,1,90,1,90,4224.530985,0.006581,109405,109405
192.168.0.38,63357,17.253.114.253,123,UDP,2,180,1678,1,90,1,90,4224.539606,0.008091,88987,88987
192.168.0.38,53092,17.253.68.123,123,UDP,2,180,1679,1,90,1,90,4224.549662,0.040772,17659,17659
192.168.0.38,56531,139.178.159.19,443,UDP,68,26226,1680,38,11325,30,14901,4224.639537,779.840249,116,152
192.168.0.38,54922,192.168.0.7,7000,TCP,12,2539,518,6,449,6,2090,4224.714668,0.043137,83269,387602
192.168.0.63,50275,192.168.0.38,7000,TCP,12,2613,519,6,449,6,2164,4225.050143,0.028599,125598,605335
192.168.0.38,52634,168.126.63.1,53,UDP,2,340,1681,1,92,1,248,4225.563932,0.005273,139578,376256
192.168.0.38,61561,168.126.63.1,53,UDP,2,278,1682,1,92,1,186,4225.564011,0.005194,141701,286484
192.168.0.38,62261,168.126.63.1,53,UDP,2,250,1683,1,86,1,164,4225.569735,0.006268,109763,209317
192.168.0.38,62456,168.126.63.1,53,UDP,2,376,1684,1,82,1,294,4225.571168,0.004836,,
192.168.0.38,51944,168.126.63.1,53,UDP,2,443,1685,1,82,1,361,4225.571243,0.004761,,
192.168.0.38,61435,168.126.63.1,53,UDP,2,245,1686,1,84,1,161,4225.576499,0.005913,113647,217825
192.168.0.38,54336,104.91.73.144,443,TCP,20,8250,520,10,1641,10,6609,4225.577722,778.902214,16,67
192.168.0.38,54337,175.207.14.51,443,TCP,22,12390,521,9,1895,13,10495,4225.583875,778.89606,19,107
192.168.0.38,57285,168.126.63.1,53,UDP,2,288,1687,1,89,1,199,4225.667164,0.005125,138926,310634
192.168.0.38,58373,168.126.63.1,53,UDP,2,244,1688,1,89,1,155,4225.667239,0.005051,140962,245495
192.168.0.38,50756,168.126.63.1,53,UDP,2,252,1689,1,96,1,156,4225.672746,0.005248,146341,237804
192.168.0.38,61024,142.250.76.129,443,UDP,31,16236,1690,16,5118,15,11118,4225.682562,0.604917,67685,147035
192.168.0.38,64271,168.126.63.1,53,UDP,2,244,1691,1,84,1,160,4225.858407,0.00527,127514,242884
192.168.0.38,62914,168.126.63.1,53,UDP,2,296,1692,1,84,1,212,4225.858475,0.005203,129156,325965
192.168.0.38,54338,17.248.221.7,443,TCP,32,12725,522,13,3424,19,9301,4225.867966,2.194129,12484,33912
fe80::18dc:d5c2:8ea2:90e4,5353,fe80::102a:21ec:c118:a887,5353,UDP,2,654,1693,2,654,0,0,4226.066507,778.983816,6,0
192.168.0.166,5353,192.168.0.38,5353,UDP,1,302,1694,1,302,0,0,4226.17127,0,,
192.168.0.38,61615,142.250.76.129,443,UDP,33,17425,1695,17,5379,16,12046,4226.331391,0.638948,67348,150822
192.168.0.38,58770,142.250.76.129,443,UDP,35,17832,1696,18,5644,17,12188,4226.978642,0.670375,67353,145446
192.168.0.169,57289,192.168.0.38,7000,TCP,12,2614,523,6,449,6,2165,4227.396622,0.040134,89500,431554
192.168.0.38,49287,142.250.76.129,443,UDP,33,17653,1697,17,5559,16,12094,4227.632712,0.668221,66552,144790
192.168.0.38,61663,168.126.63.2,53,UDP,2,198,1698,1,91,1,107,4228.07053,0.005609,129791,152611
192.168.0.38,21730,168.126.63.2,53,UDP,2,232,1699,1,91,1,141,4228.070588,0.005552,131123,203170
192.168.0.38,65187,172.217.161.202,443,UDP,51,10165,1700,25,4416,26,5749,4228.07685,1.966127,17968,23392
192.168.0.23,51435,192.168.0.38,7000,TCP,12,2613,524,6,449,6,2164,4228.125659,0.046596,77088,371534
192.168.0.166,5353,224.0.0.251,5353,UDP,4,1145,1701,4,1145,0,0,4228.209398,783.784263,11,0
fe80::18ca:ebdb:a42e:419a,5353,ff02::fb,5353,UDP,4,1225,1702,4,1225,0,0,4228.2094,783.784262,12,0
192.168.0.38,59532,172.217.161.202,443,UDP,65,16416,1703,36,7636,29,8780,4228.31571,776.164107,78,90
192.168.0.38,63486,142.250.76.129,443,UDP,45,31588,1704,19,7630,26,23958,4228.319307,0.754468,80904,254038
192.168.0.38,54339,17.248.221.7,443,TCP,36,13871,525,18,3966,18,9905,4229.012529,775.467323,40,102
192.168.0.38,55651,142.250.206.206,443,UDP,31,12916,1705,20,7915,11,5001,4230.195714,774.284087,81,51
192.168.0.38,64131,142.250.206.206,443,UDP,3,3876,1706,3,3876,0,0,5004.47982,7E-06,,
192.168.0.38,65221,172.217.161.202,443,UDP,3,3876,1707,3,3876,0,0,5004.47983,7E-06,,
192.168.0.38,62231,168.126.63.1,53,UDP,3,249,1708,3,249,0,0,5004.479854,3E-06,,
192.168.0.38,63842,168.126.63.1,53,UDP,3,249,1709,3,249,0,0,5004.479859,3E-06,,
192.168.0.38,63338,168.126.63.1,53,UDP,2,200,1710,2,200,0,0,5004.479865,2E-06,,
192.168.0.38,63212,168.126.63.1,53,UDP,2,164,1711,2,164,0,0,5004.479871,2E-06,,
192.168.0.38,55423,142.250.206.206,443,UDP,7,7510,1712,7,7510,0,0,5004.479876,1.9E-05,,
192.168.0.38,65131,142.250.76.131,443,UDP,9,8613,1713,9,8613,0,0,5004.479897,1.9E-05,,
192.168.0.38,56055,168.126.63.2,53,UDP,2,200,1714,2,200,0,0,5004.479918,1E-06,,
192.168.0.38,50846,168.126.63.2,53,UDP,2,164,1715,2,164,0,0,5004.479921,1E-06,,
192.168.0.38,61443,168.126.63.2,53,UDP,2,166,1716,2,166,0,0,5004.479924,1E-06,,
192.168.0.38,52531,168.126.63.2,53,UDP,2,166,1717,2,166,0,0,5004.479926,1E-06,,
192.168.0.38,54923,192.168.0.7,7000,TCP,5,390,526,5,390,0,0,5004.479928,6E-06,,
192.168.0.38,28804,168.126.63.2,53,UDP,1,79,1718,1,79,0,0,5004.479938,0,,
192.168.0.38,11417,168.126.63.2,53,UDP,1,79,1719,1,79,0,0,5004.47994,0,,
192.168.0.38,51673,168.126.63.2,53,UDP,1,79,1720,1,79,0,0,5004.479941,0,,
192.168.0.38,13062,168.126.63.1,53,UDP,1,79,1721,1,79,0,0,5004.479942,0,,
192.168.0.38,58908,168.126.63.2,53,UDP,1,79,1722,1,79,0,0,5004.479944,0,,
192.168.0.38,48111,168.126.63.1,53,UDP,1,79,1723,1,79,0,0,5004.479945,0,,
192.168.0.38,60044,168.126.63.1,53,UDP,1,79,1724,1,79,0,0,5004.479946,0,,
192.168.0.38,60022,168.126.63.1,53,UDP,2,158,1725,2,158,0,0,5004.479948,1E-06,,
192.168.0.38,65516,172.217.161.202,443,UDP,7,7137,1726,7,7137,0,0,5004.479951,1.3E-05,,
192.168.0.38,50627,142.250.76.131,443,UDP,5,5284,1727,5,5284,0,0,5004.479966,7E-06,,
192.168.0.38,54924,142.250.76.131,443,TCP,3,234,527,3,234,0,0,5004.479975,3E-06,,
192.168.0.38,54925,142.250.76.131,443,TCP,3,234,528,3,234,0,0,5004.47998,3E-06,,
192.168.0.38,54926,142.250.76.131,443,TCP,3,234,529,3,234,0,0,5004.479985,3E-06,,
192.168.0.38,56335,168.126.63.2,53,UDP,1,79,1728,1,79,0,0,5004.479989,0,,
fe80::1000:158b:a565:dd3f,5353,fe80::102a:21ec:c118:a887,5353,UDP,1,324,1729,1,324,0,0,5005.071831,0,,
fe80::104b:82fd:b8fa:a3d6,5353,fe80::102a:21ec:c118:a887,5353,UDP,1,324,1730,1,324,0,0,5005.077365,0,,
fe80::807:ac3d:1c77:dc5a,5353,fe80::102a:21ec:c118:a887,5353,UDP,1,331,1731,1,331,0,0,5005.080326,0,,
fe80::14c2:d5d6:415b:a476,5353,fe80::102a:21ec:c118:a887,5353,UDP,1,287,1732,1,287,0,0,5005.098249,0,,
fe80::14d9:ba51:6353:9e5e,5353,fe80::102a:21ec:c118:a887,5353,UDP,1,300,1733,1,300,0,0,5005.10631,0,,
fe80::148d:898b:b6d1:e25a,5353,fe80::102a:21ec:c118:a887,5353,UDP,1,305,1734,1,305,0,0,5005.226089,0,,
192.168.0.38,51870,168.126.63.1,53,UDP,2,334,1735,1,77,1,257,5010.713829,0.008477,72667,242538
192.168.0.38,56762,168.126.63.1,53,UDP,2,301,1736,1,77,1,224,5010.71386,0.008447,72925,212146
192.168.0.38,63883,168.126.63.1,53,UDP,2,236,1737,1,78,1,158,5010.713884,0.011794,52908,107173
192.168.0.38,51536,168.126.63.1,53,UDP,2,236,1738,1,81,1,155,5010.723257,0.007821,82853,158547
192.168.0.38,54931,17.253.115.201,80,TCP,11,1315,530,6,539,5,776,5010.735654,0.032192,133946,192842
192.168.0.38,51027,168.126.63.1,53,UDP,2,270,1739,1,100,1,170,5010.802566,0.007072,113122,192307
192.168.0.38,63021,168.126.63.1,53,UDP,2,236,1740,1,78,1,158,5010.802704,0.006933,90004,182316
192.168.0.38,52012,168.126.63.1,53,UDP,2,240,1741,1,85,1,155,5010.803925,0.007587,89626,163437
192.168.0.38,25210,168.126.63.1,53,UDP,2,299,1742,1,75,1,224,5010.875714,0.006641,90347,269838
192.168.0.38,30602,168.126.63.1,53,UDP,2,202,1743,1,75,1,127,5010.87576,0.006596,90964,154032
192.168.0.38,59551,168.126.63.1,53,UDP,2,265,1744,1,95,1,170,5010.876567,0.005789,131283,234928
192.168.0.38,54895,168.126.63.1,53,UDP,2,174,1745,1,79,1,95,5010.877494,0.005574,113383,136347
192.168.0.38,58715,168.126.63.1,53,UDP,2,164,1746,1,74,1,90,5010.877567,0.0055,107636,130909
192.168.0.38,51659,168.126.63.1,53,UDP,2,341,1747,1,82,1,259,5010.88226,0.00582,112714,356013
192.168.0.38,56443,168.126.63.1,53,UDP,2,302,1748,1,73,1,229,5010.882323,0.005756,101459,318276
192.168.0.38,61106,168.126.63.1,53,UDP,2,203,1749,1,75,1,128,5010.882403,0.005675,105726,180440
192.168.0.38,49986,142.250.206.238,443,UDP,27,8084,1750,13,3391,14,4693,5010.88348,2.092976,12961,17938
192.168.0.38,64220,168.126.63.1,53,UDP,2,397,1751,1,92,1,305,5010.884394,0.006898,106697,353725
192.168.0.38,56491,168.126.63.1,53,UDP,2,166,1752,1,75,1,91,5010.884672,0.00662,90634,109969
192.168.0.38,62224,168.126.63.1,53,UDP,2,324,1753,1,84,1,240,5010.884674,0.006617,101556,290161
192.168.0.38,56845,168.126.63.1,53,UDP,2,210,1754,1,75,1,135,5010.884675,0.006617,90675,163215
192.168.0.38,54411,168.126.63.1,53,UDP,2,355,1755,1,85,1,270,5010.885124,0.006168,110246,350194
192.168.0.38,57822,168.126.63.1,53,UDP,2,391,1756,1,85,1,306,5010.885207,0.006086,111731,402234
192.168.0.38,56767,142.250.76.131,443,UDP,51,13788,1757,23,5059,28,8729,5010.891853,1.069013,37859,65323
192.168.0.38,59388,168.126.63.1,53,UDP,2,286,1758,1,105,1,181,5010.892214,0.006474,129749,223663
192.168.0.38,54340,17.57.145.149,5223,TCP,73,17542,531,46,10736,27,6806,5010.900756,2013.04738,42,27
192.168.0.38,50326,168.126.63.1,53,UDP,2,322,1759,1,78,1,244,5010.901868,0.006327,98624,308519
192.168.0.38,61415,168.126.63.1,53,UDP,2,342,1760,1,82,1,260,5010.934715,0.00797,82308,260978
192.168.0.38,61721,168.126.63.1,53,UDP,2,287,1761,1,82,1,205,5010.934802,0.007884,83206,208016
192.168.0.38,54341,17.248.221.11,443,TCP,80,52106,532,32,8114,48,43992,5010.942247,3.129741,20740,112448
192.168.0.38,49608,168.126.63.1,53,UDP,2,361,1762,1,137,1,224,5010.943279,0.005127,213770,349522
192.168.0.38,54342,3.90.90.242,443,TCP,27,9410,533,14,2831,13,6579,5010.94982,2012.998623,11,26
192.168.0.38,64386,168.126.63.1,53,UDP,2,286,1763,1,85,1,201,5011.813732,0.008307,81858,193571
192.168.0.38,57457,168.126.63.1,53,UDP,2,338,1764,1,85,1,253,5011.813818,0.008222,82704,246168
192.168.0.38,58679,168.126.63.1,53,UDP,2,248,1765,1,86,1,162,5011.82255,0.007816,88024,165813
192.168.0.38,54343,17.248.221.15,443,TCP,30,13033,534,17,4716,13,8317,5011.835364,2012.112932,18,33
192.168.0.38,65188,168.126.63.1,53,UDP,2,207,1766,1,76,1,131,5011.872418,0.005666,107306,184962
192.168.0.38,62409,239.255.255.250,1900,UDP,4,872,1767,4,872,0,0,5011.873013,3.01481,2313,0
192.168.0.38,54932,142.251.8.188,443,TCP,21,9622,535,10,1499,11,8123,5011.878254,0.206968,57941,313980
192.168.0.38,10652,168.126.63.1,53,UDP,2,208,1768,1,79,1,129,5012.037079,0.00631,100158,163549
192.168.0.38,28094,168.126.63.1,53,UDP,2,242,1769,1,79,1,163,5012.037106,0.006283,100588,207544
192.168.0.38,51298,142.250.207.110,443,UDP,76,24389,1770,38,13251,38,11138,5012.043846,22.304098,4752,3994
192.168.0.38,54344,17.248.221.11,443,TCP,69,27807,536,30,10952,39,16855,5012.297115,1.057781,82829,127474
192.168.0.3,49552,192.168.0.38,7000,TCP,13,2678,537,6,449,7,2229,5012.810305,0.166152,21618,107323
192.168.0.38,51396,168.126.63.1,53,UDP,2,261,1771,1,78,1,183,5013.018956,0.005824,107142,251373
192.168.0.38,64054,168.126.63.1,53,UDP,2,314,1772,1,78,1,236,5013.019055,0.005724,109014,329839
192.168.0.38,62162,168.126.63.1,53,UDP,2,227,1773,1,76,1,151,5013.025354,0.005998,101367,201400
192.168.0.38,54345,17.248.221.65,443,TCP,26,10115,538,11,3428,15,6687,5013.033852,0.394853,69453,135483
192.168.0.169,137,192.168.0.255,137,UDP,3,330,1774,3,330,0,0,5013.52987,3.072032,859,0
192.168.0.38,49214,168.126.63.1,53,UDP,2,166,1775,1,75,1,91,5014.037327,0.006299,95253,115573
192.168.0.38,13167,168.126.63.1,53,UDP,2,200,1776,1,75,1,125,5014.037395,0.006231,96292,160487
192.168.0.38,50530,168.126.63.1,53,UDP,2,264,1777,1,82,1,182,5016.732725,0.010054,65247,144817
192.168.0.38,63923,168.126.63.1,53,UDP,2,239,1778,1,82,1,157,5016.743828,0.007336,89422,171210
192.168.0.38,54348,23.212.13.145,443,TCP,19,8230,539,8,1395,11,6835,5016.755375,0.381165,29278,143454
192.168.0.38,54346,23.212.13.145,443,TCP,19,8230,540,8,1395,11,6835,5016.756905,0.396444,28150,137926
192.168.0.38,54347,23.212.13.145,443,TCP,19,8230,541,8,1395,11,6835,5016.758386,0.044675,249804,1223950
192.168.0.38,63442,168.126.63.1,53,UDP,2,344,1779,1,75,1,269,5020.488772,0.011184,53648,192417
192.168.0.38,63781,168.126.63.1,53,UDP,2,284,1780,1,75,1,209,5020.489042,0.010913,54980,153211
192.168.0.38,56713,168.126.63.1,53,UDP,2,288,1781,1,106,1,182,5020.500965,0.006068,139749,239947
192.168.0.38,54349,40.70.161.102,443,TCP,23,8944,542,11,2669,12,6275,5020.508534,1.21596,17559,41284
192.168.0.38,30983,168.126.63.1,53,UDP,2,198,1782,1,91,1,107,5030.722496,0.00703,103556,121763
192.168.0.38,57551,168.126.63.1,53,UDP,2,242,1783,1,91,1,151,5030.722646,0.006881,105798,175555
192.168.0.38,55344,172.217.25.170,443,UDP,42,9067,1784,21,3794,21,5273,5030.730362,3.101945,9784,13599
192.168.0.38,58139,168.126.63.1,53,UDP,2,249,1785,1,76,1,173,5030.909379,0.007364,82563,187941
192.168.0.38,56696,168.126.63.1,53,UDP,2,207,1786,1,76,1,131,5030.909588,0.007157,84951,146430
192.168.0.38,62693,168.126.63.1,53,UDP,2,237,1787,1,85,1,152,5030.917791,0.007291,93265,166780
192.168.0.38,54350,211.249.219.27,443,TCP,20,9784,543,9,1787,11,7997,5030.929252,0.319031,44810,200532
192.168.0.38,49420,172.217.25.170,443,UDP,67,18294,1788,39,8476,28,9818,5030.978065,1992.970082,34,39
192.168.0.38,58811,168.126.63.1,53,UDP,2,267,1789,1,82,1,185,5031.297125,0.005411,121234,273516
192.168.0.38,49965,168.126.63.1,53,UDP,2,225,1790,1,82,1,143,5031.297303,0.005231,125406,218696
192.168.0.38,57969,168.126.63.1,53,UDP,2,249,1791,1,91,1,158,5031.303611,0.005826,124957,216958
192.168.0.38,54351,121.53.203.203,443,TCP,22,7691,544,10,1797,12,5894,5031.313269,0.110955,129566,424965
192.168.0.38,60569,142.250.76.131,443,UDP,9,8616,1792,9,8616,0,0,7023.948094,2.5E-05,,
192.168.0.38,51278,172.217.25.170,443,UDP,3,3876,1793,3,3876,0,0,7023.948148,3E-06,,
192.168.0.38,52341,168.126.63.1,53,UDP,2,200,1794,2,200,0,0,7023.948154,1E-06,,
192.168.0.38,60493,168.126.63.1,53,UDP,1,95,1795,1,95,0,0,7023.948157,0,,
192.168.0.38,64292,168.126.63.1,53,UDP,1,74,1796,1,74,0,0,7023.948159,0,,
192.168.0.38,52342,168.126.63.1,53,UDP,1,95,1797,1,95,0,0,7023.948161,0,,
192.168.0.38,50190,168.126.63.1,53,UDP,2,274,1798,2,274,0,0,7023.948164,1E-06,,
192.168.0.38,63335,168.126.63.1,53,UDP,2,158,1799,2,158,0,0,7023.948166,1E-06,,
192.168.0.38,52517,168.126.63.1,53,UDP,2,274,1800,2,274,0,0,7023.948169,1E-06,,
192.168.0.38,50964,168.126.63.1,53,UDP,2,166,1801,2,166,0,0,7023.948172,1E-06,,
192.168.0.38,57552,168.126.63.1,53,UDP,2,150,1802,2,150,0,0,7023.948176,1E-06,,
192.168.0.38,54834,168.126.63.1,53,UDP,2,150,1803,2,150,0,0,7023.948178,1E-06,,
192.168.0.38,54696,168.126.63.1,53,UDP,2,170,1804,2,170,0,0,7023.948182,1E-06,,
192.168.0.38,60115,168.126.63.1,53,UDP,2,158,1805,2,158,0,0,7023.948184,2E-06,,
192.168.0.38,59589,168.126.63.1,53,UDP,2,168,1806,2,168,0,0,7023.948187,1E-06,,
192.168.0.38,53697,168.126.63.1,53,UDP,2,192,1807,2,192,0,0,7023.948189,1E-06,,
192.168.0.38,51092,168.126.63.1,53,UDP,2,192,1808,2,192,0,0,7023.948192,2E-06,,
192.168.0.38,64860,168.126.63.1,53,UDP,2,152,1809,2,152,0,0,7023.948195,1E-06,,
192.168.0.38,55291,168.126.63.1,53,UDP,2,190,1810,2,190,0,0,7023.948198,1E-06,,
192.168.0.38,62484,168.126.63.1,53,UDP,2,212,1811,2,212,0,0,7023.9482,1E-06,,
192.168.0.38,51448,168.126.63.1,53,UDP,2,164,1812,2,164,0,0,7023.948203,1E-06,,
192.168.0.38,54736,168.126.63.1,53,UDP,2,170,1813,2,170,0,0,7023.948205,1E-06,,
192.168.0.38,53184,168.126.63.1,53,UDP,2,164,1814,2,164,0,0,7023.948208,1E-06,,
192.168.0.38,63330,168.126.63.1,53,UDP,2,164,1815,2,164,0,0,7023.948211,1E-06,,
192.168.0.38,54873,168.126.63.1,53,UDP,2,172,1816,2,172,0,0,7023.948213,1E-06,,
192.168.0.38,61069,168.126.63.1,53,UDP,2,172,1817,2,172,0,0,7023.948215,1E-06,,
192.168.0.38,51908,168.126.63.2,53,UDP,2,200,1818,2,200,0,0,7023.948217,1E-06,,
192.168.0.38,61678,168.126.63.2,53,UDP,2,148,1819,2,148,0,0,7023.948222,1E-06,,
192.168.0.38,59405,168.126.63.2,53,UDP,2,190,1820,2,190,0,0,7023.948225,0,,
192.168.0.38,53091,168.126.63.2,53,UDP,2,274,1821,2,274,0,0,7023.948227,0,,
192.168.0.38,53533,168.126.63.2,53,UDP,2,158,1822,2,158,0,0,7023.948229,1E-06,,
192.168.0.38,56910,168.126.63.2,53,UDP,2,274,1823,2,274,0,0,7023.948231,1E-06,,
192.168.0.38,59727,168.126.63.2,53,UDP,2,166,1824,2,166,0,0,7023.948233,1E-06,,
192.168.0.38,61910,168.126.63.2,53,UDP,2,150,1825,2,150,0,0,7023.948235,1E-06,,
192.168.0.38,53847,168.126.63.2,53,UDP,2,150,1826,2,150,0,0,7023.948236,1E-06,,
192.168.0.38,61978,168.126.63.2,53,UDP,2,170,1827,2,170,0,0,7023.948239,0,,
192.168.0.38,59395,168.126.63.2,53,UDP,2,158,1828,2,158,0,0,7023.94824,1E-06,,
192.168.0.38,55219,168.126.63.2,53,UDP,2,168,1829,2,168,0,0,7023.948242,1E-06,,
192.168.0.38,62618,168.126.63.2,53,UDP,2,192,1830,2,192,0,0,7023.948244,1E-06,,
192.168.0.38,56122,168.126.63.2,53,UDP,2,192,1831,2,192,0,0,7023.948246,0,,
192.168.0.38,60650,168.126.63.2,53,UDP,2,152,1832,2,152,0,0,7023.948247,1E-06,,
192.168.0.38,61704,168.126.63.2,53,UDP,2,190,1833,2,190,0,0,7023.948249,1E-06,,
192.168.0.38,50146,168.126.63.2,53,UDP,2,164,1834,2,164,0,0,7023.948252,1E-06,,
192.168.0.38,52926,168.126.63.2,53,UDP,2,170,1835,2,170,0,0,7023.948253,1E-06,,
192.168.0.38,51771,168.126.63.2,53,UDP,2,164,1836,2,164,0,0,7023.948255,0,,
192.168.0.38,56485,168.126.63.2,53,UDP,2,164,1837,2,164,0,0,7023.948256,1E-06,,
192.168.0.38,58943,168.126.63.2,53,UDP,2,172,1838,2,172,0,0,7023.948258,0,,
192.168.0.38,50517,168.126.63.2,53,UDP,2,172,1839,2,172,0,0,7023.948259,1E-06,,
192.168.0.38,56388,142.250.76.131,443,UDP,6,6580,1840,6,6580,0,0,7023.948261,8E-06,,
192.168.0.38,54933,142.250.76.131,443,TCP,6,468,545,6,468,0,0,7023.94827,5E-06,,
192.168.0.38,54934,142.250.76.131,443,TCP,6,468,546,6,468,0,0,7023.948276,6E-06,,
192.168.0.38,54935,142.250.76.131,443,TCP,6,468,547,6,468,0,0,7023.948284,6E-06,,
192.168.0.38,53079,168.126.63.1,53,UDP,1,85,1841,1,85,0,0,7023.948298,0,,
169.254.60.30,5353,224.0.0.251,5353,UDP,15,6798,1842,15,6798,0,0,7023.948889,2E-05,,
192.168.219.1,67,192.168.219.101,68,UDP,3,1026,1843,3,1026,0,0,7197.242737,1100.250083,7,0
192.168.219.100,5353,224.0.0.251,5353,UDP,2,1164,1844,2,1164,0,0,7197.419198,3.899652,2387,0
fe80::2e2b:f9ff:fe36:b19c,5353,ff02::fb,5353,UDP,1,656,1845,1,656,0,0,7197.425148,0,,
192.168.219.101,5353,224.0.0.251,5353,UDP,62,36545,1846,62,36545,0,0,7199.955425,1967.961228,148,0
192.168.219.21,5353,192.168.219.101,5353,UDP,4,1525,1847,4,1525,0,0,7200.252743,1796.82512,6,0
192.168.219.101,63675,61.41.153.2,53,UDP,2,281,1848,1,102,1,179,7200.252824,0.010424,78280,137375
192.168.219.101,57507,61.41.153.2,53,UDP,2,243,1849,1,84,1,159,7200.252974,0.010275,65401,123795
192.168.219.101,62548,61.41.153.2,53,UDP,2,232,1850,1,78,1,154,7200.252976,0.013721,45477,89789
192.168.219.101,54958,61.41.153.2,53,UDP,2,225,1851,1,88,1,137,7200.252978,0.018496,38062,59256
192.168.219.101,34185,61.41.153.2,53,UDP,2,440,1852,1,75,1,365,7200.252989,0.018486,32456,157957
192.168.219.101,54952,61.41.153.2,53,UDP,2,199,1853,1,75,1,124,7200.25299,0.018485,32458,53665
192.168.219.101,46678,61.41.153.2,53,UDP,2,166,1854,1,75,1,91,7200.252991,0.025632,23408,28401
192.168.219.101,64469,61.41.153.2,53,UDP,2,207,1855,1,75,1,132,7200.252992,0.025632,23408,41198
192.168.219.101,57557,61.41.153.2,53,UDP,2,265,1856,1,95,1,170,7200.254462,0.024161,31455,56289
192.168.219.101,55277,61.41.153.2,53,UDP,2,174,1857,1,79,1,95,7200.254597,0.024027,26303,31631
192.168.219.101,65048,61.41.153.2,53,UDP,2,164,1858,1,74,1,90,7200.254675,0.023949,24719,30063
192.168.219.101,52738,61.41.153.2,53,UDP,2,296,1859,1,73,1,223,7200.254752,0.028844,20246,61849
192.168.219.101,50103,61.41.153.2,53,UDP,2,264,1860,1,78,1,186,7200.254915,0.028677,21759,51888
192.168.219.101,51427,61.41.153.2,53,UDP,2,322,1861,1,78,1,244,7200.254991,0.028604,21815,68242
192.168.219.101,55727,61.41.153.2,53,UDP,2,200,1862,1,75,1,125,7200.255063,0.028531,21029,35049
192.168.219.101,51195,61.41.153.2,53,UDP,2,341,1863,1,82,1,259,7200.255144,0.02845,23057,72829
192.168.219.101,54128,61.41.153.2,53,UDP,2,239,1864,1,79,1,160,7200.255213,0.028383,22266,45097
192.168.219.101,53573,61.41.153.2,53,UDP,2,383,1865,1,92,1,291,7200.255694,0.027902,26378,83434
192.168.219.101,57763,61.41.153.2,53,UDP,2,374,1866,1,84,1,290,7200.255794,0.027801,24171,83450
192.168.219.101,61716,61.41.153.2,53,UDP,2,336,1867,1,82,1,254,7200.256281,0.027317,24014,74385
192.168.219.101,61336,61.41.153.2,53,UDP,2,284,1868,1,82,1,202,7200.256432,0.027162,24151,59494
192.168.219.101,59516,61.41.153.2,53,UDP,2,328,1869,1,85,1,243,7200.259963,0.023634,28772,82254
192.168.219.101,55066,61.41.153.2,53,UDP,2,297,1870,1,85,1,212,7200.260272,0.023325,29153,72711
192.168.219.101,54080,142.250.66.110,443,UDP,18,11671,1871,8,4053,10,7618,7200.272411,0.263896,122866,230939
192.168.219.101,62219,61.41.153.2,53,UDP,2,264,1872,1,82,1,182,7200.278234,0.007028,93340,207171
192.168.219.101,63581,61.41.153.2,53,UDP,2,222,1873,1,82,1,140,7200.278317,0.006945,94456,161267
192.168.219.101,55067,172.217.25.3,443,UDP,54,13032,1874,24,3991,30,9041,7200.279427,25.734597,1240,2810
192.168.219.101,53057,61.41.153.2,53,UDP,2,215,1875,1,79,1,136,7200.279565,0.007867,80335,138299
192.168.219.101,57381,61.41.153.2,53,UDP,2,241,1876,1,84,1,157,7200.284581,0.01042,64491,120537
192.168.219.101,60299,17.253.114.125,123,UDP,2,180,1877,1,90,1,90,7200.28801,0.01072,67164,67164
192.168.219.101,57626,61.41.153.2,53,UDP,2,276,1878,1,105,1,171,7200.288245,0.006757,124315,202456
192.168.219.101,52839,61.41.153.2,53,UDP,2,358,1879,1,137,1,221,7200.288335,0.010396,105425,170065
192.168.219.101,54321,61.41.153.2,53,UDP,2,246,1880,1,91,1,155,7200.288639,0.010092,72136,122869
192.168.219.101,49204,142.250.204.142,443,UDP,34,20556,1881,17,5099,17,15457,7200.291432,0.3533,115459,350002
192.168.219.101,63762,17.57.145.138,5223,TCP,164,50490,548,94,36600,70,13890,7200.2991,1972.776239,148,56
192.168.219.101,63761,17.248.221.4,443,TCP,57,21945,549,24,7693,33,14252,7200.300342,1097.19487,56,103
192.168.219.101,53095,17.253.114.125,123,UDP,2,180,1882,1,90,1,90,7200.300758,0.123644,5823,5823
192.168.219.101,63763,3.90.90.242,443,TCP,24,9107,550,10,2474,14,6633,7200.301013,1098.099991,18,48
192.168.219.101,63764,121.53.203.203,443,TCP,31,10291,551,13,2353,18,7938,7200.305498,1853.287178,10,34
192.168.219.101,54199,17.253.114.253,123,UDP,2,180,1883,1,90,1,90,7200.428218,0.008748,82304,82304
192.168.219.101,63765,142.250.204.142,443,TCP,3,206,552,2,132,1,74,7200.447373,0.047666,22154,12419
192.168.219.101,58540,61.41.153.2,53,UDP,2,246,1884,1,76,1,170,7200.493119,0.00766,79373,177545
192.168.219.101,62578,61.41.153.2,53,UDP,2,204,1885,1,76,1,128,7200.493321,0.00746,81501,137265
192.168.219.101,54924,61.41.153.2,53,UDP,2,234,1886,1,85,1,149,7200.501694,0.009576,71010,124477
192.168.219.101,63766,211.249.201.68,443,TCP,30,10465,553,15,2850,15,7615,7200.515008,1097.347249,20,55
192.168.219.101,59634,142.250.204.142,443,UDP,30,14807,1887,17,7035,13,7772,7200.630611,0.198675,283276,312953
192.168.219.101,62634,61.41.153.2,53,UDP,2,280,1888,1,85,1,195,7200.773376,0.007412,91743,210469
192.168.219.101,61370,61.41.153.2,53,UDP,2,338,1889,1,85,1,253,7200.773449,0.007339,92655,275786
192.168.219.101,62144,61.41.153.2,53,UDP,2,245,1890,1,86,1,159,7200.781318,0.014074,48884,90379
192.168.219.101,63767,17.248.221.8,443,TCP,28,12769,554,13,4329,15,8440,7200.798139,1097.736521,31,61
192.168.219.101,31408,61.41.153.2,53,UDP,2,198,1891,1,79,1,119,7200.960212,0.013322,47440,71460
192.168.219.101,61935,61.41.153.2,53,UDP,2,232,1892,1,79,1,153,7200.960271,0.013262,47654,92293
192.168.219.101,63056,142.251.220.14,443,UDP,68,28829,1893,35,16029,33,12800,7200.974062,24.387091,5258,4198
192.168.219.101,38784,61.41.153.2,53,UDP,2,197,1894,1,76,1,121,7201.159512,0.037515,16206,25803
192.168.219.101,54410,239.255.255.250,1900,UDP,4,872,1895,4,872,0,0,7201.16117,3.013,2315,0
192.168.219.21,38458,192.168.219.101,54410,UDP,1,558,1896,1,558,0,0,7201.197028,0,,
192.168.219.101,54938,64.233.189.188,443,TCP,28,10198,555,13,1847,15,8351,7201.197632,1711.973011,8,39
192.168.219.100,5353,192.168.219.101,5353,UDP,3,1697,1897,3,1697,0,0,7201.356992,1712.157876,7,0
192.168.219.100,43646,192.168.219.101,54410,UDP,4,1512,1898,4,1512,0,0,7201.356992,0.192214,62929,0
192.168.219.101,60294,61.41.153.2,53,UDP,2,359,1899,1,72,1,287,7201.385607,0.007184,80178,319599
192.168.219.101,54937,61.41.153.2,53,UDP,2,314,1900,1,72,1,242,7201.385662,0.009238,62351,209569
192.168.219.101,62326,61.41.153.2,53,UDP,2,357,1901,1,82,1,275,7201.391618,0.006616,99153,332527
192.168.219.101,61463,61.41.153.2,53,UDP,2,437,1902,1,82,1,355,7201.391699,0.006536,100367,434516
192.168.219.101,53578,61.41.153.2,53,UDP,2,236,1903,1,86,1,150,7201.393157,0.006713,102487,178757
192.168.219.101,52361,61.41.153.2,53,UDP,2,235,1904,1,84,1,151,7201.39873,0.004426,,
192.168.219.101,63768,104.75.167.5,443,TCP,20,8250,556,10,1641,10,6609,7201.40194,10.733659,1223,4925
192.168.219.101,63769,175.207.14.49,443,TCP,24,14137,557,9,1895,15,12242,7201.404316,10.731337,1412,9126
192.168.219.101,54939,192.168.219.21,8008,TCP,23,2889,558,12,960,11,1929,7202.1662,2033.288973,3,7
192.168.219.101,54940,192.168.219.100,1689,TCP,12,2457,559,6,629,6,1828,7202.166349,1723.020834,2,8
192.168.219.101,53803,61.41.153.2,53,UDP,2,264,1905,1,89,1,175,7202.219433,0.038786,18357,36095
192.168.219.101,61224,61.41.153.2,53,UDP,2,223,1906,1,89,1,134,7202.219572,0.038647,18423,27738
192.168.219.21,38101,192.168.219.101,54410,UDP,1,558,1907,1,558,0,0,7202.258778,0,,
192.168.219.101,56239,61.41.153.2,53,UDP,2,249,1908,1,96,1,153,7202.258801,0.006142,125040,199283
192.168.219.101,55104,142.251.220.33,443,UDP,30,16069,1909,15,5037,15,11032,7202.269053,0.688536,58524,128179
192.168.219.100,57724,192.168.219.101,54410,UDP,4,1512,1910,4,1512,0,0,7202.548963,0.200183,60424,0
192.168.219.101,62570,142.251.220.33,443,UDP,35,17612,1911,18,5268,17,12344,7202.962446,1.148665,36689,85971
192.168.219.21,48274,192.168.219.101,54410,UDP,1,558,1912,1,558,0,0,7203.180217,0,,
192.168.219.101,137,192.168.219.255,137,UDP,21,2148,1913,21,2148,0,0,7203.301043,1718.428024,9,0
192.168.219.100,44501,192.168.219.101,54410,UDP,4,1512,1914,4,1512,0,0,7203.469488,0.202502,59732,0
192.168.219.101,62081,61.41.153.2,53,UDP,2,213,1915,1,78,1,135,7203.618614,0.009206,67781,117314
192.168.219.101,64793,61.41.153.2,53,UDP,2,412,1916,1,78,1,334,7203.618678,0.009142,68256,292277
192.168.219.101,63770,142.250.204.138,443,TCP,26,10098,560,12,2056,14,8042,7203.634174,1093.816858,15,58
192.168.219.101,65159,142.251.220.33,443,UDP,36,17781,1917,19,5353,17,12428,7204.115157,0.776794,55129,127992
192.168.219.101,54941,192.168.219.100,8009,TCP,2,132,561,1,78,1,54,7204.167617,0.006085,102547,70994
192.168.219.101,54942,192.168.219.21,8009,TCP,258,42771,562,167,21069,91,21702,7204.167865,2054.898386,82,84
192.168.219.101,54943,192.168.219.100,8009,TCP,2,132,563,1,78,1,54,7204.175707,0.011177,55828,38650
192.168.219.21,36284,192.168.219.101,54410,UDP,1,558,1918,1,558,0,0,7204.182033,0,,
192.168.219.100,41984,192.168.219.101,54410,UDP,4,1512,1919,4,1512,0,0,7204.409099,0.200016,60475,0
192.168.219.101,56513,142.251.220.33,443,UDP,34,17493,1920,17,5383,17,12110,7204.938081,0.705194,61066,137380
192.168.219.101,60130,61.41.153.2,53,UDP,2,303,1921,1,82,1,221,7205.347655,0.039877,16450,44336
192.168.219.101,60051,61.41.153.2,53,UDP,2,261,1922,1,82,1,179,7205.347755,0.039776,16492,36001
192.168.219.101,55810,61.41.153.2,53,UDP,2,225,1923,1,82,1,143,7205.388987,0.006179,106166,185143
192.168.219.101,63772,104.109.240.226,443,TCP,22,8440,564,10,1551,12,6889,7205.398711,1097.46403,11,50
192.168.219.101,63771,104.109.240.226,443,TCP,23,8506,565,11,1617,12,6889,7205.400166,1097.345403,11,50
192.168.219.101,63773,104.109.240.226,443,TCP,21,8374,566,9,1485,12,6889,7205.447607,1097.415134,10,50
192.168.219.101,51529,142.251.220.33,443,UDP,32,17600,1924,17,5569,15,12031,7205.647947,0.6674,66754,144213
192.168.219.101,53675,142.251.220.33,443,UDP,34,17746,1925,17,5563,17,12183,7206.323827,0.777917,57209,125288
192.168.219.101,52363,142.251.220.33,443,UDP,43,29095,1926,19,7628,24,21467,7207.073182,0.779411,78295,220340
192.168.219.101,51989,61.41.153.2,53,UDP,2,338,1927,1,75,1,263,7208.352307,0.009227,65026,228026
192.168.219.101,63491,61.41.153.2,53,UDP,2,284,1928,1,75,1,209,7208.352402,0.009134,65688,183052
192.168.219.101,62054,61.41.153.2,53,UDP,2,282,1929,1,106,1,176,7208.362518,0.007744,109504,181818
192.168.219.101,63774,52.177.138.113,443,TCP,36,10171,567,24,3904,12,6267,7208.373043,1809.657376,17,27
192.168.219.101,36825,61.41.153.2,53,UDP,2,198,1930,1,91,1,107,7211.757601,0.022367,32547,38270
192.168.219.101,17242,61.41.153.2,53,UDP,2,232,1931,1,91,1,141,7211.757656,0.022311,32629,50558
192.168.219.101,64475,216.58.203.74,443,UDP,67,18330,1932,34,7887,33,10443,7211.781216,1701.420096,37,49
192.168.219.101,50202,216.58.203.74,443,UDP,31,11698,1933,14,3617,17,8081,7212.067884,0.728537,39717,88736
192.168.219.101,54944,192.168.219.100,8009,TCP,2,132,568,1,78,1,54,7218.886846,0.006646,93891,65001
192.168.219.101,54945,192.168.219.100,8009,TCP,2,132,569,1,78,1,54,7227.54283,0.006926,90095,62373
192.168.219.21,9956,192.168.219.255,9956,UDP,12,1918,1934,12,1918,0,0,7230.198484,2000.211017,7,0
192.168.219.101,63977,61.41.153.2,53,UDP,2,228,1935,1,106,1,122,8297.39747,0.013451,63043,72559
192.168.219.101,57310,61.41.153.2,53,UDP,2,186,1936,1,85,1,101,8297.397474,0.013448,50565,60083
192.168.219.101,63237,61.41.153.2,53,UDP,2,281,1937,1,102,1,179,8297.397477,0.013443,60700,106523
192.168.219.101,59236,61.41.153.2,53,UDP,2,243,1938,1,84,1,159,8297.397479,0.01344,49999,94642
192.168.219.101,63309,61.41.153.2,53,UDP,2,282,1939,1,106,1,176,8297.397481,0.01344,63095,104761
192.168.219.101,55552,61.41.153.2,53,UDP,2,228,1940,1,106,1,122,8297.397485,0.013437,63109,72635
192.168.219.101,55063,61.41.153.2,53,UDP,2,186,1941,1,85,1,101,8297.39749,0.013432,50625,60154
192.168.219.101,62468,61.41.153.2,53,UDP,2,296,1942,1,73,1,223,8297.397493,0.013429,43487,132846
192.168.219.101,62205,61.41.153.2,53,UDP,2,303,1943,1,96,1,207,8297.397497,0.053533,14346,30934
192.168.219.101,63931,61.41.153.2,53,UDP,2,349,1944,1,96,1,253,8297.3975,0.015234,50413,132860
192.168.219.101,58755,61.41.153.2,53,UDP,2,348,1945,1,103,1,245,8297.397504,0.013419,61405,146061
192.168.219.101,53196,61.41.153.2,53,UDP,2,267,1946,1,95,1,172,8297.397506,0.013418,56640,102548
192.168.219.101,51925,61.41.153.2,53,UDP,2,212,1947,1,82,1,130,8297.397508,0.013416,48896,77519
192.168.219.101,54543,61.41.153.2,53,UDP,2,225,1948,1,82,1,143,8297.39751,0.013413,48907,85290
192.168.219.101,60735,61.41.153.2,53,UDP,2,180,1949,1,82,1,98,8297.397513,0.013412,48911,58455
192.168.219.101,53149,61.41.153.2,53,UDP,2,246,1950,1,76,1,170,8297.397517,0.015217,39955,89373
192.168.219.101,52764,61.41.153.2,53,UDP,2,204,1951,1,76,1,128,8297.39752,0.013403,45362,76400
192.168.219.101,55535,61.41.153.2,53,UDP,2,264,1952,1,82,1,182,8297.397523,0.015209,43132,95732
192.168.219.101,61356,61.41.153.2,53,UDP,2,222,1953,1,82,1,140,8297.397525,0.0134,48955,83582
192.168.219.101,54954,61.41.153.2,53,UDP,2,296,1954,1,84,1,212,8297.397528,0.015206,44193,111534
192.168.219.101,59259,61.41.153.2,53,UDP,2,245,1955,1,86,1,159,8297.397531,0.013394,51366,94967
192.168.219.101,54585,61.41.153.2,53,UDP,2,300,1956,1,86,1,214,8297.397533,0.013391,51377,127847
192.168.219.101,53594,17.253.114.125,123,UDP,2,180,1957,1,90,1,90,8297.416969,0.007697,93542,93542
192.168.219.101,58178,61.41.153.2,53,UDP,2,246,1958,1,91,1,155,8297.417136,0.005707,127562,217277
192.168.219.101,60507,61.41.153.2,53,UDP,2,234,1959,1,85,1,149,8297.417559,0.005285,128666,225543
192.168.219.101,53788,17.253.114.125,123,UDP,2,180,1960,1,90,1,90,8297.426835,0.030526,23586,23586
192.168.219.101,61103,61.41.153.2,53,UDP,2,276,1961,1,105,1,171,8297.451733,0.010353,81135,132135
192.168.219.101,65330,17.253.114.253,123,UDP,2,180,1962,1,90,1,90,8297.459337,0.035873,20070,20070
192.168.219.101,62625,61.41.153.2,53,UDP,2,174,1963,1,79,1,95,8297.495402,0.008322,75943,91324
192.168.219.101,53690,61.41.153.2,53,UDP,2,164,1964,1,74,1,90,8297.495431,0.00829,71411,86851
192.168.219.101,55331,61.41.153.2,53,UDP,2,200,1965,1,75,1,125,8297.495439,0.045821,13094,21824
192.168.219.101,53619,61.41.153.2,53,UDP,2,318,1966,1,95,1,223,8297.495447,0.008276,91831,215563
192.168.219.103,5353,192.168.219.101,5353,UDP,3,979,1967,2,540,1,439,8297.824832,801.314393,5,4
192.168.219.101,61244,61.41.153.2,53,UDP,2,249,1968,1,96,1,153,8297.869587,0.091484,8394,13379
192.168.219.101,61982,61.41.153.2,53,UDP,2,208,1969,1,96,1,112,8297.869667,0.091402,8402,9802
192.168.219.101,54945,142.250.66.33,443,UDP,31,16228,1970,16,5118,15,11110,8297.965742,0.763614,53618,116393
192.168.219.101,57269,142.250.66.33,443,UDP,35,17564,1971,18,5452,17,12112,8298.73331,0.625104,69773,155007
192.168.219.101,57088,142.250.66.33,443,UDP,35,17815,1972,18,5638,17,12177,8299.338354,0.723544,62337,134637
192.168.219.103,5353,224.0.0.251,5353,UDP,21,5179,1973,21,5179,0,0,8299.894008,848.812248,48,0
fe80::408:d6a1:c61c:6373,5353,ff02::fb,5353,UDP,20,5129,1974,20,5129,0,0,8299.896493,839.268382,48,0
192.168.219.101,50020,142.250.66.33,443,UDP,33,17663,1975,17,5559,16,12104,8299.979952,0.737087,60334,131371
192.168.219.101,59738,142.250.66.33,443,UDP,46,30492,1976,21,7790,25,22702,8300.731685,0.771359,80792,235449
192.168.219.103,63019,192.168.219.101,7000,TCP,12,2616,570,6,449,6,2167,8302.230802,0.057797,62148,299946
192.168.219.101,55550,61.41.153.2,53,UDP,2,281,1977,1,102,1,179,8912.935191,0.18256,4469,7843
192.168.219.101,53269,61.41.153.2,53,UDP,2,243,1978,1,84,1,159,8912.935192,0.182558,3681,6967
192.168.219.101,65141,17.253.114.125,123,UDP,2,180,1979,1,90,1,90,8912.935194,0.182557,3943,3943
192.168.219.101,53445,17.253.114.125,123,UDP,1,90,1980,1,90,0,0,8913.121207,0,,
192.168.219.101,50192,216.58.203.74,443,UDP,22,7148,1981,11,3876,11,3272,8913.20959,0.580757,53392,45072
192.168.219.101,64256,61.41.153.2,53,UDP,2,254,1982,1,80,1,174,8913.229149,0.138472,4621,10052
192.168.219.101,55824,61.41.153.2,53,UDP,2,268,1983,1,80,1,188,8913.229258,0.138362,4625,10870
192.168.219.101,58513,61.41.153.2,53,UDP,2,230,1984,1,90,1,140,8913.368876,0.053777,13388,20826
192.168.219.101,63775,163.171.75.66,80,TCP,11,2413,571,6,582,5,1831,8913.425393,30.800524,151,475
192.168.219.101,50045,216.58.203.74,443,UDP,20,8581,1985,11,3888,9,4693,8913.611981,0.264111,117768,142152
192.168.219.103,63026,192.168.219.101,54946,TCP,120,66215,572,65,43697,55,22518,8914.086184,75.166317,4650,2396
192.168.219.101,64999,61.41.153.2,53,UDP,2,212,1986,1,98,1,114,8914.743211,0.012767,61408,71434
192.168.219.101,12833,61.41.153.2,53,UDP,2,246,1987,1,98,1,148,8914.743266,0.061909,12663,19124
192.168.219.101,64094,142.250.66.74,443,UDP,23,11597,1988,12,3834,11,7763,8914.769564,0.500084,61333,124187
192.168.219.101,54947,142.250.66.74,443,TCP,29,13499,573,13,1425,16,12074,8914.834367,172.415218,66,560
fe80::408:d6a1:c61c:6373,63025,fe80::102a:21ec:c118:a887,54946,TCP,3,270,574,2,172,1,98,8914.95521,0.006962,197644,112611
192.168.219.101,63623,17.253.114.253,123,UDP,2,180,1989,1,90,1,90,8915.125001,0.00906,79470,79470
192.168.219.101,63791,61.41.153.2,53,UDP,2,194,1990,1,81,1,113,8915.197931,0.036924,17549,24482
192.168.219.101,60932,142.250.66.74,443,UDP,37,18191,1991,18,4839,19,13352,8915.198496,1.304856,29667,81860
192.168.219.101,54948,211.249.221.162,443,TCP,12,1564,575,7,903,5,661,8915.238123,0.142628,50649,37075
192.168.219.101,54949,142.250.66.74,443,TCP,30,13565,576,14,1491,16,12074,8915.258117,171.991426,69,561
192.168.219.101,54950,121.53.200.253,443,TCP,30,12085,577,14,1932,16,10153,8915.346285,180.435833,85,450
192.168.219.101,60024,61.41.153.2,53,UDP,2,197,1992,1,71,1,126,8917.337672,0.014167,40093,71151
192.168.219.101,49470,61.41.153.2,53,UDP,2,222,1993,1,71,1,151,8917.337768,0.014072,40363,85844
192.168.219.101,63776,162.159.128.233,443,TCP,24,7897,578,12,2363,12,5534,8917.354032,61.494015,307,719
192.168.219.101,53631,162.159.137.232,443,UDP,582,531789,1994,164,78591,418,453198,8917.736315,26.467473,23754,136982
192.168.219.101,54951,162.159.137.232,443,TCP,25,4635,579,13,1367,12,3268,8917.748816,315.180274,34,82
192.168.219.101,58744,61.41.153.2,53,UDP,2,236,1995,1,78,1,158,8918.017611,0.00695,89784,181870
192.168.219.101,54952,162.159.136.234,443,TCP,470,292737,580,172,15245,298,277492,8918.028104,344.445679,354,6444
192.168.219.101,59228,61.41.153.2,53,UDP,2,246,1996,1,76,1,170,8918.989045,0.006757,89980,201272
192.168.219.101,52611,61.41.153.2,53,UDP,2,204,1997,1,76,1,128,8918.989143,0.006658,91318,153799
192.168.219.101,60888,61.41.153.2,53,UDP,2,234,1998,1,85,1,149,8918.997265,0.005296,128398,225075
192.168.219.101,63777,211.249.201.68,443,TCP,23,8727,581,12,2016,11,6711,8919.005186,30.967931,520,1733
192.168.219.101,53414,61.41.153.2,53,UDP,2,236,1999,1,78,1,158,8925.542143,0.005987,104225,211124
192.168.219.101,62799,162.159.138.232,443,UDP,20,8821,2000,10,2566,10,6255,8925.548843,0.130606,157175,383137
192.168.219.101,54953,162.159.138.232,443,TCP,25,4635,582,13,1367,12,3268,8925.560424,315.139171,34,82
192.168.219.101,61729,61.41.153.2,53,UDP,2,338,2001,1,75,1,263,8927.299122,0.006295,95313,334233
192.168.219.101,52651,61.41.153.2,53,UDP,2,284,2002,1,75,1,209,8927.299238,0.006181,97071,270506
192.168.219.101,52528,61.41.153.2,53,UDP,2,282,2003,1,106,1,176,8927.306053,0.007559,112184,186268
192.168.219.101,54205,61.41.153.2,53,UDP,2,228,2004,1,106,1,122,8927.306151,0.007462,113642,130796
192.168.219.101,63778,40.70.161.7,443,TCP,25,8708,583,12,2384,13,6324,8927.319074,31.898646,597,1586
192.168.219.101,63302,142.251.220.14,443,UDP,21,8249,2005,11,4208,10,4041,8928.57579,0.470448,71557,68717
192.168.219.101,64064,172.217.25.3,443,UDP,23,6389,2006,11,2724,12,3665,8928.868208,0.16786,129822,174669
192.168.219.104,5353,224.0.0.251,5353,UDP,19,2856,2007,19,2856,0,0,8929.964015,326.548317,69,0
192.168.219.21,5353,224.0.0.251,5353,UDP,34,13666,2008,34,13666,0,0,8929.967944,326.55203,334,0
192.168.219.101,58782,61.41.153.2,53,UDP,2,258,2009,1,89,1,169,8930.469815,0.011262,63221,120049
192.168.219.101,54954,162.159.128.235,443,TCP,106,17924,584,68,9342,38,8582,8930.481689,330.103817,226,207
192.168.219.101,62006,61.41.153.2,53,UDP,2,174,2010,1,79,1,95,8932.624286,0.025877,24423,29369
192.168.219.101,56640,61.41.153.2,53,UDP,2,164,2011,1,74,1,90,8932.624626,0.025536,23182,28195
192.168.219.101,61322,61.41.153.2,53,UDP,2,296,2012,1,73,1,223,8932.624721,0.025443,22953,70117
192.168.219.101,53441,61.41.153.2,53,UDP,2,200,2013,1,75,1,125,8932.624816,0.025347,23671,39452
192.168.219.101,54885,61.41.153.2,53,UDP,2,374,2014,1,84,1,290,8932.625081,0.025082,26792,92496
192.168.219.101,60309,61.41.153.2,53,UDP,2,318,2015,1,95,1,223,8932.625519,0.024645,30837,72387
192.168.219.101,62078,61.41.153.2,53,UDP,2,348,2016,1,103,1,245,8932.625589,0.024574,33531,79759
192.168.219.101,53364,61.41.153.2,53,UDP,2,296,2017,1,84,1,212,8932.634306,0.015858,42376,106949
192.168.219.101,53351,66.22.228.211,50001,UDP,2,232,2018,1,116,1,116,8932.984381,0.041215,22516,22516
192.168.219.101,55270,66.22.228.211,50001,UDP,15824,17861456,2019,15102,17780674,722,80782,8932.984411,60.056953,2368508,10760
192.168.219.101,62128,61.41.153.2,53,UDP,2,242,2020,1,81,1,161,8937.376861,0.004623,,
192.168.219.101,54959,162.159.138.234,443,TCP,34,6817,585,17,2098,17,4719,8937.382223,315.383773,53,119
192.168.219.101,52683,66.22.229.61,50001,UDP,2,100,2021,1,50,1,50,8937.506581,0.00876,45662,45662
192.168.219.101,52683,66.22.228.215,50003,UDP,2,100,2022,1,50,1,50,8937.506649,0.008692,46019,46019
192.168.219.101,52683,66.22.229.7,50003,UDP,2,100,2023,1,50,1,50,8937.50666,0.008681,46077,46077
192.168.219.101,52683,66.22.229.207,50002,UDP,2,100,2024,1,50,1,50,8937.506675,0.008666,46157,46157
192.168.219.101,52683,66.22.228.212,50001,UDP,2,100,2025,1,50,1,50,8937.506697,0.008643,46280,46280
192.168.219.101,52683,66.22.248.167,50004,UDP,2,100,2026,1,50,1,50,8937.506705,0.040042,9989,9989
192.168.219.101,52683,66.22.248.174,50002,UDP,2,100,2027,1,50,1,50,8937.506718,0.04003,9992,9992
192.168.219.101,52683,66.22.210.22,50002,UDP,2,100,2028,1,50,1,50,8937.506738,0.040009,9997,9997
192.168.219.101,52683,66.22.208.33,50003,UDP,2,100,2029,1,50,1,50,8937.506757,0.039991,10002,10002
192.168.219.101,52683,66.22.248.58,50004,UDP,2,100,2030,1,50,1,50,8937.506772,0.039976,10006,10006
192.168.219.101,52683,66.22.218.71,50004,UDP,2,100,2031,1,50,1,50,8937.506787,0.095558,4185,4185
192.168.219.101,52683,66.22.219.101,50002,UDP,2,100,2032,1,50,1,50,8937.506802,0.088565,4516,4516
192.168.219.101,52683,66.22.218.63,50001,UDP,2,100,2033,1,50,1,50,8937.506818,0.088551,4517,4517
192.168.219.101,52683,66.22.219.23,50003,UDP,2,100,2034,1,50,1,50,8937.506839,0.088529,4518,4518
192.168.219.101,52683,66.22.219.99,50004,UDP,2,100,2035,1,50,1,50,8937.506846,0.08852,4518,4518
192.168.219.101,52683,66.22.221.64,50001,UDP,2,100,2036,1,50,1,50,8937.506868,0.108783,3677,3677
192.168.219.101,52683,66.22.220.67,50004,UDP,2,100,2037,1,50,1,50,8937.506875,0.107215,3730,3730
192.168.219.101,52683,66.22.220.27,50001,UDP,2,100,2038,1,50,1,50,8937.506898,0.107649,3715,3715
192.168.219.101,52683,66.22.221.19,50002,UDP,2,100,2039,1,50,1,50,8937.506905,0.108747,3678,3678
192.168.219.101,52683,66.22.220.121,50003,UDP,2,100,2040,1,50,1,50,8937.506926,0.107163,3732,3732
192.168.219.101,52683,66.22.239.14,50002,UDP,2,100,2041,1,50,1,50,8937.506933,0.275979,1449,1449
192.168.219.101,52683,66.22.239.12,50002,UDP,2,100,2042,1,50,1,50,8937.506957,0.270233,1480,1480
192.168.219.101,52683,66.22.239.7,50004,UDP,2,100,2043,1,50,1,50,8937.506965,0.270224,1480,1480
192.168.219.101,52683,66.22.239.5,50004,UDP,2,100,2044,1,50,1,50,8937.506986,0.264438,1512,1512
192.168.219.101,52683,66.22.239.136,50003,UDP,2,100,2045,1,50,1,50,8937.506993,0.271879,1471,1471
192.168.219.101,51927,61.41.153.2,53,UDP,2,236,2046,1,78,1,158,8937.872888,0.005716,109167,221133
192.168.219.101,56617,162.159.134.233,443,UDP,21,9181,2047,10,2900,11,6281,8937.879627,0.105558,219784,476022
192.168.219.101,54960,162.159.134.233,443,TCP,26,4711,586,13,1367,13,3344,8937.890118,315.588861,34,84
192.168.219.101,63216,61.41.153.2,53,UDP,2,198,2048,1,79,1,119,8959.560921,0.008256,76550,115310
192.168.219.101,35155,61.41.153.2,53,UDP,2,232,2049,1,79,1,153,8959.560997,0.00818,77261,149633
192.168.219.101,57149,142.250.199.78,443,UDP,76,21543,2050,38,12975,38,8568,8959.570095,31.559545,3289,2171
192.168.219.101,51889,61.41.153.2,53,UDP,2,189,2051,1,75,1,114,8959.84549,0.008928,67204,102150
192.168.219.101,54961,117.52.156.26,80,TCP,10,1392,587,6,990,4,402,8959.85573,0.016579,477712,193980
192.168.219.101,52950,61.41.153.2,53,UDP,2,195,2052,1,77,1,118,8960.078961,0.004786,,
192.168.219.101,54962,211.233.80.46,80,TCP,11,2092,588,6,676,5,1416,8960.085233,0.021246,254542,533182
192.168.219.101,54963,211.233.80.46,80,TCP,11,1964,589,6,623,5,1341,8960.102572,0.022607,220462,474543
192.168.219.101,51327,61.41.153.2,53,UDP,2,215,2053,1,74,1,141,8960.116455,0.008724,67858,129298
192.168.219.101,54964,222.239.240.37,80,TCP,161,138255,590,62,7791,99,130464,8960.125982,0.47534,131122,2195716
192.168.219.101,54965,64.233.189.188,5228,TCP,32,10818,591,15,1733,17,9085,8961.058602,268.555144,51,270
192.168.219.101,6568,61.41.153.2,53,UDP,2,168,2054,1,76,1,92,8969.702765,0.013055,46572,56376
192.168.219.101,63176,61.41.153.2,53,UDP,2,202,2055,1,76,1,126,8969.702831,0.01299,46805,77598
192.168.219.101,54906,142.250.204.46,443,UDP,36,23158,2056,21,14059,15,9099,8969.716628,0.381863,294534,190623
192.168.219.101,51604,61.41.153.2,53,UDP,2,166,2057,1,75,1,91,8970.445212,0.004395,,
192.168.219.101,49097,61.41.153.2,53,UDP,2,207,2058,1,75,1,132,8970.445298,0.004308,,
192.168.219.101,56051,172.217.24.67,443,UDP,18,5902,2059,9,2466,9,3436,8970.450005,0.127561,154655,215489
192.168.219.101,46851,61.41.153.2,53,UDP,2,166,2060,1,75,1,91,8970.634616,0.012425,48289,58591
192.168.219.101,21126,61.41.153.2,53,UDP,2,200,2061,1,75,1,125,8970.634638,0.012402,48379,80632
192.168.219.101,61657,142.251.220.46,443,UDP,201,152025,2062,125,131820,76,20205,8970.647485,2.043646,516018,79093
192.168.219.101,5093,61.41.153.2,53,UDP,2,258,2063,1,85,1,173,8972.55924,0.106593,6379,12983
192.168.219.101,14344,61.41.153.2,53,UDP,2,244,2064,1,85,1,159,8972.559283,0.05801,11722,21927
192.168.219.101,50773,216.239.32.180,443,UDP,29,15959,2065,15,6749,14,9210,8972.666291,0.353577,152702,208384
192.168.219.101,38090,61.41.153.2,53,UDP,2,190,2066,1,87,1,103,8978.700677,0.005637,123469,146177
192.168.219.101,37292,61.41.153.2,53,UDP,2,231,2067,1,87,1,144,8978.700796,0.005516,126178,208846
192.168.219.101,50295,172.217.24.234,443,UDP,24,17631,2068,10,5238,14,12393,8978.707423,0.192697,217460,514507
192.168.219.101,47273,61.41.153.2,53,UDP,2,198,2069,1,91,1,107,8983.426813,0.018949,38418,45173
192.168.219.101,58217,61.41.153.2,53,UDP,2,232,2070,1,91,1,141,8983.426871,0.018892,38534,59707
192.168.219.101,54007,142.250.199.74,443,UDP,486,46268,2071,241,23830,245,22438,8983.446789,279.675385,681,641
192.168.219.101,59191,142.250.199.74,443,UDP,26,6486,2072,13,2992,13,3494,8983.792369,0.67017,35716,41708
192.168.219.101,54126,61.41.153.2,53,UDP,2,292,2073,1,80,1,212,8987.060252,0.00486,,
192.168.219.101,59011,61.41.153.2,53,UDP,2,245,2074,1,80,1,165,8987.060363,0.00475,,
192.168.219.101,60165,61.41.153.2,53,UDP,2,248,2075,1,91,1,157,8987.067018,0.011523,63177,108999
192.168.219.101,63779,17.56.10.43,443,TCP,30,9308,592,12,2745,18,6563,8987.083253,90.855406,241,577
192.168.219.101,56071,61.41.153.2,53,UDP,2,200,2076,1,75,1,125,8987.491062,0.046395,12932,21554
192.168.219.101,55171,61.41.153.2,53,UDP,2,308,2077,1,106,1,202,8987.492429,0.00928,91379,174137
192.168.219.101,63281,61.41.153.2,53,UDP,2,322,2078,1,105,1,217,8987.492488,0.009222,91086,188245
192.168.219.101,64376,61.41.153.2,53,UDP,2,186,2079,1,85,1,101,8987.492553,0.009157,74260,88238
192.168.219.101,52197,61.41.153.2,53,UDP,2,296,2080,1,84,1,212,8987.501035,0.004707,,
192.168.219.103,63030,192.168.219.101,7000,TCP,15,2802,593,7,515,8,2287,8988.329845,0.40182,10253,45532
192.168.219.101,56163,61.41.153.2,53,UDP,2,186,2081,1,85,1,101,8988.422079,0.01696,40094,47641
192.168.219.101,63780,211.249.201.68,443,TCP,30,12264,594,15,2709,15,9555,8988.441892,30.317551,714,2521
192.168.219.101,62058,66.22.228.211,50001,UDP,17541,20018504,2082,16816,19935668,725,82836,8993.017371,60.024519,2657003,11040
192.168.219.101,65060,239.255.255.250,1900,UDP,4,872,2083,4,872,0,0,8994.042571,3.022242,2308,0
192.168.219.21,43203,192.168.219.101,65060,UDP,1,558,2084,1,558,0,0,8994.072677,0,,
192.168.219.100,43789,192.168.219.101,65060,UDP,4,1512,2085,4,1512,0,0,8994.230578,0.145923,82893,0
192.168.219.21,38514,192.168.219.101,65060,UDP,1,558,2086,1,558,0,0,8995.05975,0,,
192.168.219.100,47310,192.168.219.101,65060,UDP,4,1512,2087,4,1512,0,0,8995.099905,0.193533,62500,0
192.168.219.21,36416,192.168.219.101,65060,UDP,1,558,2088,1,558,0,0,8996.074638,0,,
192.168.219.100,41268,192.168.219.101,65060,UDP,4,1512,2089,4,1512,0,0,8996.326326,0.209079,57853,0
192.168.219.21,49487,192.168.219.101,65060,UDP,1,558,2090,1,558,0,0,8997.077863,0,,
192.168.219.100,36833,192.168.219.101,65060,UDP,4,1512,2091,4,1512,0,0,8997.254078,0.248545,48667,0
192.168.219.101,61603,61.41.153.2,53,UDP,2,284,2092,1,76,1,208,9003.005081,0.025532,23813,65173
192.168.219.101,55815,61.41.153.2,53,UDP,2,253,2093,1,76,1,177,9003.005187,0.025427,23911,55688
192.168.219.101,64795,61.41.153.2,53,UDP,2,232,2094,1,78,1,154,9003.005273,0.025341,24624,48616
192.168.219.101,63965,61.41.153.2,53,UDP,2,246,2095,1,90,1,156,9003.031446,0.005442,132304,229327
192.168.219.101,63781,17.36.206.4,443,TCP,23,8312,595,11,1772,12,6540,9003.040102,1.121123,12644,46667
192.168.219.101,65211,162.159.138.232,443,UDP,41,21471,2096,20,10788,21,10683,9011.335594,0.976801,88353,87493
192.168.219.101,51958,61.41.153.2,53,UDP,2,350,2097,1,73,1,277,9014.017657,0.00957,61024,231556
192.168.219.101,61947,61.41.153.2,53,UDP,2,305,2098,1,73,1,232,9014.01774,0.009487,61557,195636
192.168.219.101,51905,61.41.153.2,53,UDP,2,236,2099,1,86,1,150,9014.027963,0.013988,49185,85787
192.168.219.101,63782,125.56.144.40,443,TCP,31,10312,596,13,1784,18,8528,9014.046025,120.408172,118,566
192.168.219.101,61592,61.41.153.2,53,UDP,2,326,2100,1,74,1,252,9014.324528,0.010796,54835,186735
192.168.219.101,61669,61.41.153.2,53,UDP,2,284,2101,1,74,1,210,9014.324606,0.010718,55234,156745
192.168.219.101,55782,61.41.153.2,53,UDP,2,227,2102,1,83,1,144,9014.336212,0.008252,80465,139602
192.168.219.101,63783,104.75.164.75,443,TCP,27,8934,597,12,1818,15,7116,9014.34634,31.135719,467,1828
192.168.219.101,63331,61.41.153.2,53,UDP,2,338,2103,1,104,1,234,9017.00685,0.022982,36202,81455
192.168.219.101,51364,61.41.153.2,53,UDP,2,284,2104,1,104,1,180,9017.006932,0.0229,36331,62882
192.168.219.101,65317,61.41.153.2,53,UDP,2,282,2105,1,106,1,176,9017.030429,0.004903,,
192.168.219.101,55498,61.41.153.2,53,UDP,2,228,2106,1,106,1,122,9017.030497,0.004836,,
192.168.219.101,63784,52.177.138.113,443,TCP,26,8774,598,12,2384,14,6390,9017.037886,64.927976,293,787
192.168.219.101,54966,192.168.219.100,36866,TCP,17,1775,599,9,848,8,927,9018.061157,210.305706,32,35
192.168.219.101,59263,216.239.32.180,443,UDP,75,53202,2107,29,5090,46,48112,9021.293344,0.603016,67527,638284
192.168.219.101,51436,142.250.199.78,443,UDP,23,8399,2108,12,4278,11,4121,9021.295692,0.46152,74154,71433
192.168.219.101,2597,61.41.153.2,53,UDP,2,198,2109,1,79,1,119,9029.783053,0.020808,30372,45751
192.168.219.101,28073,61.41.153.2,53,UDP,2,232,2110,1,79,1,153,9029.783153,0.020707,30521,59110
192.168.219.101,65109,172.217.24.78,443,UDP,26,14813,2111,13,5933,13,8880,9029.804944,0.266516,178090,266550
192.168.219.101,63359,61.41.153.2,53,UDP,2,168,2112,1,76,1,92,9034.822821,0.004146,,
192.168.219.101,45001,61.41.153.2,53,UDP,2,202,2113,1,76,1,126,9034.823314,0.055248,11004,18245
192.168.219.101,59496,172.217.24.110,443,UDP,25,11170,2114,13,6924,12,4246,9034.840352,0.364804,151840,93113
192.168.219.101,37916,61.41.153.2,53,UDP,2,198,2115,1,91,1,107,9044.698114,0.028044,25959,30523
192.168.219.101,61991,61.41.153.2,53,UDP,2,232,2116,1,91,1,141,9044.698167,0.027991,26008,40298
192.168.219.101,60236,172.217.24.106,443,UDP,18,5603,2117,9,2465,9,3138,9044.726777,0.228177,86424,110019
192.168.219.101,46237,61.41.153.2,53,UDP,2,166,2118,1,75,1,91,9049.555005,0.009821,61093,74126
192.168.219.101,29563,61.41.153.2,53,UDP,2,207,2119,1,75,1,132,9049.55512,0.009705,61823,108809
192.168.219.101,60739,142.250.66.35,443,UDP,22,6320,2120,10,2655,12,3665,9049.565695,0.11826,179604,247928
192.168.219.101,57518,142.250.199.78,443,UDP,278,143607,2121,156,103577,122,40030,9051.685037,92.673198,8941,3455
192.168.219.101,51914,66.22.228.211,50001,UDP,17084,19478855,2122,16369,19397255,715,81600,9053.01675,60.120938,2581098,10858
192.168.219.101,49885,61.41.153.2,53,UDP,2,264,2123,1,82,1,182,9053.603049,0.004627,,
192.168.219.101,59889,61.41.153.2,53,UDP,2,222,2124,1,82,1,140,9053.603167,0.00451,,
192.168.219.101,65111,61.41.153.2,53,UDP,2,246,2125,1,91,1,155,9053.608314,0.0094,77446,131914
192.168.219.101,63785,110.76.141.203,443,TCP,26,8872,600,11,2039,15,6833,9053.619863,2.056975,7930,26574
192.168.219.101,57525,216.239.32.180,443,UDP,3114,686605,2126,1430,279681,1684,406924,9059.975746,203.856305,10975,15969
192.168.219.101,60553,61.41.153.2,53,UDP,2,172,2127,1,78,1,94,9061.173161,0.013489,46259,55749
192.168.219.101,40639,61.41.153.2,53,UDP,2,213,2128,1,78,1,135,9061.173191,0.01346,46359,80237
192.168.219.101,64001,34.64.4.17,443,UDP,59,18394,2129,31,7591,28,10803,9061.187229,28.190006,2154,3065
192.168.219.101,31768,61.41.153.2,53,UDP,2,164,2130,1,74,1,90,9061.207865,0.004899,,
192.168.219.101,39197,61.41.153.2,53,UDP,2,173,2131,1,74,1,99,9061.207919,0.004845,,
192.168.219.101,64747,142.251.220.68,443,UDP,53,41636,2132,24,12746,29,28890,9061.21313,0.371079,274787,622832
192.168.219.101,51856,172.217.24.78,443,UDP,79,26387,2133,38,17586,41,8801,9070.539899,77.556437,1814,907
192.168.219.101,63207,142.250.199.78,443,UDP,35,16775,2134,17,6653,18,10122,9079.700927,1.660219,32058,48774
192.168.219.101,47906,61.41.153.2,53,UDP,2,170,2135,1,77,1,93,9083.285928,0.008738,70496,85145
192.168.219.101,24496,61.41.153.2,53,UDP,2,211,2136,1,77,1,134,9083.285981,0.008684,70935,123445
192.168.219.101,65419,172.217.24.67,443,UDP,187,162813,2137,61,8360,126,154453,9083.295272,1.661035,40264,743887
192.168.219.101,15490,61.41.153.2,53,UDP,2,174,2138,1,79,1,95,9086.20375,0.004359,,
192.168.219.101,8075,61.41.153.2,53,UDP,2,208,2139,1,79,1,129,9086.203806,0.004304,,
192.168.219.101,50007,142.250.199.77,443,UDP,1172,1185822,2140,192,43214,980,1142608,9086.208549,8.077879,42797,1131592
192.168.219.101,8076,61.41.153.2,53,UDP,2,215,2141,1,85,1,130,9086.933779,0.006685,101720,155572
192.168.219.101,63369,61.41.153.2,53,UDP,2,256,2142,1,85,1,171,9086.933812,0.006652,102224,205652
192.168.219.101,50595,142.250.204.97,443,UDP,40,24355,2143,18,5309,22,19046,9086.940911,0.441295,96244,345274
192.168.219.101,55402,142.250.66.35,443,UDP,68,32331,2144,28,5502,40,26829,9087.051759,2.680432,16421,80073
192.168.219.101,7307,61.41.153.2,53,UDP,2,204,2145,1,80,1,124,9087.075536,0.017973,35608,55193
192.168.219.101,64720,61.41.153.2,53,UDP,2,238,2146,1,80,1,158,9087.075607,0.017901,35752,70610
192.168.219.101,50167,172.217.27.14,443,UDP,42,27622,2147,18,5178,24,22444,9087.094141,0.336662,123043,533330
192.168.219.101,54972,172.217.27.14,443,TCP,21,9863,601,11,1317,10,8546,9087.183821,64.400262,163,1061
192.168.219.101,57174,172.217.24.110,443,UDP,26,11345,2148,14,7002,12,4343,9099.556186,0.374,149775,92898
192.168.219.101,64075,142.251.220.68,443,UDP,92,59948,2149,35,5771,57,54177,9103.383034,0.462673,99785,936765
192.168.219.101,41326,61.41.153.2,53,UDP,2,166,2150,1,75,1,91,9104.74453,0.010933,54879,66587
192.168.219.101,38181,61.41.153.2,53,UDP,2,200,2151,1,75,1,125,9104.744601,0.010863,55233,92055
192.168.219.101,60552,172.217.24.238,443,UDP,567,403727,2152,182,47701,385,356026,9104.756144,55.178392,6915,51618
192.168.219.101,32012,61.41.153.2,53,UDP,2,185,2153,1,74,1,111,9105.241533,0.00795,74465,111698
192.168.219.101,25069,61.41.153.2,53,UDP,2,219,2154,1,74,1,145,9105.24158,0.007903,74908,146779
192.168.219.101,61993,142.250.204.142,443,UDP,41,31546,2155,18,7210,23,24336,9105.250054,0.308105,187208,631888
192.168.219.101,32336,61.41.153.2,53,UDP,2,166,2156,1,75,1,91,9105.495539,0.026095,22992,27898
192.168.219.101,47782,61.41.153.2,53,UDP,2,207,2157,1,75,1,132,9105.495578,0.026056,23027,40528
192.168.219.101,54258,172.217.24.99,443,UDP,18,12343,2158,8,4446,10,7897,9105.522989,29.220877,1217,2162
192.168.219.101,8333,61.41.153.2,53,UDP,2,198,2159,1,91,1,107,9105.886954,0.006556,111043,130567
192.168.219.101,34656,61.41.153.2,53,UDP,2,232,2160,1,91,1,141,9105.886991,0.00652,111656,173006
192.168.219.101,59010,172.217.24.74,443,UDP,19,7951,2161,10,3840,9,4111,9105.894302,0.268548,114392,122466
192.168.219.101,24949,61.41.153.2,53,UDP,2,198,2162,1,79,1,119,9111.004943,0.006559,96356,145144
192.168.219.101,21225,61.41.153.2,53,UDP,2,232,2163,1,79,1,153,9111.005016,0.006487,97425,188685
192.168.219.101,53330,142.250.207.78,443,UDP,40,9238,2164,20,4080,20,5158,9111.012167,5.71615,5710,7218
192.168.219.101,64820,66.22.228.211,50001,UDP,17359,19873913,2165,16676,19794537,683,79376,9113.017235,60.044985,2637294,10575
192.168.219.101,51933,239.255.255.250,1900,UDP,4,872,2166,4,872,0,0,9114.047874,3.02341,2307,0
192.168.219.21,40849,192.168.219.101,51933,UDP,1,558,2167,1,558,0,0,9114.07868,0,,
192.168.219.100,33718,192.168.219.101,51933,UDP,4,1512,2168,4,1512,0,0,9114.297668,0.185406,65240,0
192.168.219.21,48780,192.168.219.101,51933,UDP,1,558,2169,1,558,0,0,9115.095971,0,,
192.168.219.100,37406,192.168.219.101,51933,UDP,4,1512,2170,4,1512,0,0,9115.217167,0.200403,60358,0
192.168.219.21,45612,192.168.219.101,51933,UDP,1,558,2171,1,558,0,0,9116.129462,0,,
192.168.219.100,50646,192.168.219.101,51933,UDP,4,1512,2172,4,1512,0,0,9116.453997,0.216418,55891,0
192.168.219.21,41108,192.168.219.101,51933,UDP,1,558,2173,1,558,0,0,9117.255845,0,,
192.168.219.100,40851,192.168.219.101,51933,UDP,4,1512,2174,4,1512,0,0,9117.354972,0.261037,46338,0
192.168.219.101,56616,34.64.4.17,443,UDP,36,15159,2175,19,9339,17,5820,9121.176676,0.202482,368980,229946
192.168.219.101,59126,172.217.24.67,443,UDP,11,4331,2176,6,1756,5,2575,9132.232018,0.21448,65497,96046
192.168.219.101,50037,61.41.153.2,53,UDP,2,176,2177,1,80,1,96,9132.243988,0.060746,10535,12642
192.168.219.101,54165,61.41.153.2,53,UDP,2,217,2178,1,80,1,137,9132.244083,0.060651,10552,18070
192.168.219.101,56856,142.251.220.74,443,UDP,37,16415,2179,16,5621,21,10794,9132.305322,4.753019,9460,18167
192.168.219.101,56181,61.41.153.2,53,UDP,2,207,2180,1,73,1,134,9134.240064,0.00889,65691,120584
192.168.219.101,36043,61.41.153.2,53,UDP,2,248,2181,1,73,1,175,9134.240092,0.00886,65914,158013
192.168.219.101,55186,61.41.153.2,53,UDP,2,190,2182,1,87,1,103,9134.242357,0.006596,105518,124924
192.168.219.101,17951,61.41.153.2,53,UDP,2,231,2183,1,87,1,144,9134.242389,0.006564,106032,175502
192.168.219.101,34274,61.41.153.2,53,UDP,2,398,2184,1,71,1,327,9134.244009,0.004945,,
192.168.219.101,52509,61.41.153.2,53,UDP,2,199,2185,1,71,1,128,9134.244108,0.004846,,
192.168.219.101,59216,142.251.220.42,443,UDP,22,7000,2186,11,3530,11,3470,9134.249717,0.253278,111498,109602
192.168.219.101,54736,172.217.24.225,443,UDP,51,26946,2187,25,9715,26,17231,9134.249998,4.372053,17776,31529
192.168.219.101,60302,142.251.220.22,443,UDP,641,622310,2188,144,24112,497,598198,9134.250563,8.819609,21871,542607
192.168.219.101,17658,61.41.153.2,53,UDP,2,418,2189,1,81,1,337,9134.722371,0.023775,27255,113396
192.168.219.101,14526,61.41.153.2,53,UDP,2,219,2190,1,81,1,138,9134.722424,0.023721,27317,46541
192.168.219.101,54879,142.250.204.42,443,UDP,75,48219,2191,29,7130,46,41089,9134.746606,0.564468,101050,582339
192.168.219.101,6710,61.41.153.2,53,UDP,2,158,2192,1,71,1,87,9136.932715,0.008291,68508,83946
192.168.219.101,1544,61.41.153.2,53,UDP,2,157,2193,1,71,1,86,9136.93277,0.008236,68965,83535
192.168.219.101,59387,142.250.204.78,443,UDP,21,12388,2194,10,4002,11,8386,9136.941476,0.275644,116149,243386
192.168.219.101,54973,142.250.204.78,443,TCP,20,9770,602,10,1251,10,8519,9137.015229,60.548452,165,1125
192.168.219.101,63685,61.41.153.2,53,UDP,2,271,2195,1,106,1,165,9137.680456,0.009497,89291,138991
192.168.219.101,7793,61.41.153.2,53,UDP,2,312,2196,1,106,1,206,9137.680513,0.060311,14060,27325
192.168.219.101,61472,58.72.222.144,443,UDP,2,1400,2197,1,1292,1,108,9137.702981,0.006994,1477838,123534
192.168.219.101,54974,58.72.222.144,443,TCP,5704,7443558,603,822,107104,4882,7336454,9137.710502,121.555821,7048,482836
192.168.219.101,54975,58.72.222.144,443,TCP,85,85982,604,23,4405,62,81577,9137.710666,121.430978,290,5374
192.168.219.101,54960,172.217.24.99,443,UDP,17,5706,2198,8,2639,9,3067,9138.157868,0.148618,142055,165094
192.168.219.101,52969,61.41.153.2,53,UDP,2,338,2199,1,104,1,234,9149.908792,0.03593,23156,52101
192.168.219.101,63078,61.41.153.2,53,UDP,2,284,2200,1,104,1,180,9149.90896,0.035761,23265,40267
192.168.219.101,53067,61.41.153.2,53,UDP,2,282,2201,1,106,1,176,9149.945588,0.008778,96605,160401
192.168.219.101,63786,40.70.161.102,443,TCP,28,8906,605,13,2450,15,6456,9149.957654,31.54606,621,1637
192.168.219.101,51332,61.41.153.2,53,UDP,3,334,2202,2,152,1,182,9157.086764,1.05307,1154,1382
192.168.219.101,57452,61.41.153.2,53,UDP,3,392,2203,2,152,1,240,9157.087153,1.052682,1155,1823
192.168.219.101,52119,61.41.153.2,53,UDP,2,287,2204,1,87,1,200,9157.177865,0.041067,16947,38960
192.168.219.101,52958,61.41.153.2,53,UDP,2,345,2205,1,87,1,258,9157.178054,0.046135,15086,44738
192.168.219.101,57810,61.41.153.2,53,UDP,2,245,2206,1,86,1,159,9157.215496,0.04141,16614,30717
192.168.219.101,58851,61.41.153.2,53,UDP,2,300,2207,1,86,1,214,9157.215651,0.041254,16677,41499
192.168.219.101,57595,61.41.153.2,53,UDP,2,251,2208,1,89,1,162,9157.219751,0.041268,17253,31404
192.168.219.101,50381,61.41.153.2,53,UDP,2,268,2209,1,81,1,187,9157.244256,0.02191,29575,68279
192.168.219.101,60926,61.41.153.2,53,UDP,2,326,2210,1,81,1,245,9157.244339,0.021828,29686,89792
192.168.219.101,63787,17.248.221.2,443,TCP,40,18298,606,18,7547,22,10751,9157.265411,62.069258,972,1385
192.168.219.101,64985,61.41.153.2,53,UDP,2,237,2211,1,82,1,155,9157.26686,0.00581,112908,213425
192.168.219.101,63788,17.248.221.10,443,TCP,27,13203,607,12,2670,15,10533,9157.268995,31.417102,679,2682
192.168.219.101,63789,17.248.221.10,443,TCP,26,10639,608,12,2783,14,7856,9157.280129,31.563608,705,1991
192.168.219.101,63790,17.248.221.10,443,TCP,37,22664,609,14,4005,23,18659,9157.793069,61.892927,517,2411
192.168.219.101,63791,17.248.221.10,443,TCP,29,16463,610,12,3831,17,12632,9158.017786,61.676811,496,1638
192.168.219.101,49774,61.41.153.2,53,UDP,2,237,2212,1,82,1,155,9158.141098,0.004811,,
192.168.219.101,63792,17.248.221.1,443,TCP,45,28175,611,18,5523,27,22652,9158.151387,61.542698,717,2944
192.168.219.101,63793,17.248.221.1,443,TCP,29,15906,612,12,3413,17,12493,9158.154713,6.629284,4118,15076
192.168.219.101,63794,17.248.221.1,443,TCP,38,19938,613,18,6875,20,13063,9158.155521,31.685831,1735,3298
192.168.219.101,61627,61.41.153.2,53,UDP,2,252,2213,1,73,1,179,9158.20323,0.01972,29614,72616
192.168.219.101,64584,61.41.153.2,53,UDP,2,205,2214,1,73,1,132,9158.203368,0.019584,29820,53921
192.168.219.101,64346,61.41.153.2,53,UDP,2,244,2215,1,89,1,155,9158.223633,0.005704,124824,217391
192.168.219.101,63795,17.157.64.66,443,TCP,21,11125,614,11,3881,10,7244,9158.231485,6.552476,4738,8844
192.168.219.101,63796,17.248.221.1,443,TCP,53,29319,615,26,11532,27,17787,9158.325158,6.46074,14279,22024
192.168.219.101,58950,61.41.153.2,53,UDP,2,365,2216,1,88,1,277,9158.782575,0.018464,38128,120017
192.168.219.101,61218,61.41.153.2,53,UDP,2,343,2217,1,88,1,255,9158.782666,0.018375,38312,111020
192.168.219.101,60973,61.41.153.2,53,UDP,2,244,2218,1,92,1,152,9158.801959,0.006846,107508,177621
192.168.219.101,63797,17.253.75.205,443,TCP,19,8434,616,8,2221,11,6213,9158.811151,5.974604,2973,8319
192.168.219.101,53908,61.41.153.2,53,UDP,2,295,2219,1,81,1,214,9159.757806,0.077082,8406,22210
192.168.219.101,53383,61.41.153.2,53,UDP,2,248,2220,1,81,1,167,9159.757927,0.076961,8419,17359
192.168.219.101,55729,61.41.153.2,53,UDP,2,248,2221,1,91,1,157,9159.836155,0.013909,52340,90301
192.168.219.101,63798,17.42.251.13,443,TCP,26,13157,617,13,3911,13,9246,9159.852208,59.973254,521,1233
192.168.219.101,56236,61.41.153.2,53,UDP,2,249,2222,1,96,1,153,9162.045491,0.005454,140814,224422
192.168.219.101,60804,61.41.153.2,53,UDP,2,208,2223,1,96,1,112,9162.045621,0.005323,144279,168326
192.168.219.101,61839,142.250.204.33,443,UDP,34,18715,2224,16,5986,18,12729,9162.072792,1.579126,30325,64486
192.168.219.101,55168,61.41.153.2,53,UDP,2,246,2225,1,91,1,155,9163.221048,0.024925,29207,49749
192.168.219.101,58962,61.41.153.2,53,UDP,2,200,2226,1,75,1,125,9163.223207,0.022766,26355,43925
192.168.219.101,56612,61.41.153.2,53,UDP,2,318,2227,1,95,1,223,9163.223285,0.022689,33496,78628
192.168.219.101,60705,61.41.153.2,53,UDP,2,198,2228,1,91,1,107,9163.223364,0.022609,32199,37861
192.168.219.101,50375,61.41.153.2,53,UDP,2,282,2229,1,106,1,176,9163.223453,0.02252,37655,62522
192.168.219.101,51491,61.41.153.2,53,UDP,2,228,2230,1,106,1,122,9163.22613,0.019844,42733,49183
192.168.219.101,49427,61.41.153.2,53,UDP,2,268,2231,1,108,1,160,9163.226626,0.019347,44658,66160
192.168.219.101,60055,61.41.153.2,53,UDP,2,348,2232,1,103,1,245,9163.227441,0.176569,4666,11100
192.168.219.101,59920,61.41.153.2,53,UDP,2,347,2233,1,95,1,252,9163.230882,0.047383,16039,42546
192.168.219.101,60649,61.41.153.2,53,UDP,2,296,2234,1,84,1,212,9163.590174,0.005232,128440,324159
192.168.219.101,63907,142.250.204.33,443,UDP,33,16374,2235,17,5191,16,11183,9163.657418,0.555518,74755,161046
192.168.219.101,51042,142.250.204.33,443,UDP,36,18809,2236,18,5452,18,13357,9164.185721,0.768642,56744,139019
192.168.219.101,59314,142.250.204.33,443,UDP,35,17835,2237,18,5647,17,12188,9164.949314,0.598698,75457,162860
192.168.219.101,50616,142.250.204.33,443,UDP,33,17649,2238,16,5484,17,12165,9165.518743,0.566974,77379,171648
192.168.219.101,51245,142.250.204.33,443,UDP,44,30282,2239,20,8815,24,21467,9166.101777,0.884344,79742,194195
192.168.219.101,17424,61.41.153.2,53,UDP,2,198,2240,1,91,1,107,9166.922354,0.006053,120270,141417
192.168.219.101,23218,61.41.153.2,53,UDP,2,232,2241,1,91,1,141,9166.922414,0.005992,121495,188251
192.168.219.101,58728,172.217.27.10,443,UDP,68,12498,2242,31,6015,37,6483,9166.928957,70.817067,679,732
192.168.219.101,55717,142.250.204.33,443,UDP,31,16231,2243,16,5124,15,11107,9167.085782,0.552159,74239,160924
192.168.219.101,63359,142.250.204.33,443,UDP,33,17425,2244,17,5377,16,12048,9167.652742,0.569821,75490,169147
192.168.219.101,63620,142.250.204.33,443,UDP,34,17752,2245,17,5565,17,12187,9168.228131,0.594878,74838,163892
192.168.219.101,64615,142.250.204.33,443,UDP,33,17667,2246,17,5569,16,12098,9168.827735,0.559063,79690,173118
192.168.219.101,60907,142.250.204.33,443,UDP,44,29169,2247,20,7705,24,21464,9169.394207,0.654332,94202,262423
192.168.219.101,56595,142.251.220.42,443,UDP,18,5990,2248,9,2774,9,3216,9169.89256,0.170216,130375,151149
192.168.219.101,46208,61.41.153.2,53,UDP,2,166,2249,1,75,1,91,9170.551941,0.006542,91715,111280
192.168.219.101,36863,61.41.153.2,53,UDP,2,207,2250,1,75,1,132,9170.551979,0.006505,92236,162336
192.168.219.101,55894,142.250.204.35,443,UDP,28,7052,2251,13,3003,15,4049,9170.558897,28.834237,833,1123
192.168.219.101,53703,61.41.153.2,53,UDP,2,241,2252,1,84,1,157,9172.383506,0.004343,,
192.168.219.101,63799,17.248.221.15,443,TCP,50,16202,618,20,5368,30,10834,9172.392883,31.629815,1357,2740
192.168.219.101,63800,17.248.221.15,443,TCP,48,15698,619,19,5011,29,10687,9172.476452,31.49725,1272,2714
192.168.219.101,52293,66.22.228.211,50001,UDP,17242,19657268,2253,16510,19574202,732,83066,9173.01678,60.065175,2607061,11063
192.168.219.101,49344,142.250.207.78,443,UDP,361,229219,2254,215,178722,146,50497,9174.315152,65.690184,21765,6149
192.168.219.101,49202,61.41.153.2,53,UDP,2,438,2255,1,91,1,347,9190.318148,0.005922,122931,468760
192.168.219.101,64710,61.41.153.2,53,UDP,2,239,2256,1,91,1,148,9190.318182,0.005887,123662,201121
192.168.219.101,57012,61.41.153.2,53,UDP,2,238,2257,1,78,1,160,9191.094288,0.005452,114453,234776
192.168.219.101,59181,61.41.153.2,53,UDP,2,284,2258,1,78,1,206,9191.094391,0.005349,116657,308094
192.168.219.101,63801,52.41.58.77,443,TCP,30,15736,620,15,9184,15,6552,9191.102158,0.685187,107229,76498
192.168.219.101,57182,61.41.153.2,53,UDP,2,198,2259,1,79,1,119,9195.056326,0.004444,,
192.168.219.101,63107,61.41.153.2,53,UDP,2,232,2260,1,79,1,153,9195.056364,0.004408,,
192.168.219.101,55038,142.251.220.46,443,UDP,53,16006,2261,24,9403,29,6603,9195.061261,44.546977,1688,1185
192.168.219.101,31607,61.41.153.2,53,UDP,2,440,2262,1,75,1,365,9195.673636,0.016198,37041,180269
192.168.219.101,63655,61.41.153.2,53,UDP,2,199,2263,1,75,1,124,9195.67367,0.016165,37117,61367
192.168.219.101,54322,61.41.153.2,53,UDP,2,341,2264,1,76,1,265,9202.518187,0.004719,,
192.168.219.101,60297,61.41.153.2,53,UDP,2,295,2265,1,76,1,219,9202.518299,0.004608,,
192.168.219.101,58700,61.41.153.2,53,UDP,2,235,2266,1,85,1,150,9202.523586,0.003638,,
192.168.219.101,63802,23.194.210.47,443,TCP,26,11716,621,11,1619,15,10097,9202.530033,0.261982,49438,308326
192.168.219.101,61027,142.250.207.78,443,UDP,16,6083,2267,8,2667,8,3416,9204.083493,0.280769,75991,97332
192.168.219.101,35058,61.41.153.2,53,UDP,2,281,2268,1,118,1,163,9210.769188,0.099676,9470,13082
192.168.219.101,15607,61.41.153.2,53,UDP,2,322,2269,1,118,1,204,9210.769221,0.053029,17801,30775
192.168.219.101,53251,172.217.31.1,443,UDP,37,12898,2270,21,4725,16,8173,9210.86934,27.682518,1365,2361
192.168.219.101,54983,172.217.31.1,443,TCP,19,10812,622,8,1119,11,9693,9210.926227,45.178322,198,1716
192.168.219.101,53272,66.22.228.211,50001,UDP,9039,10350950,2271,8667,10308348,372,42602,9233.017088,30.816298,2676076,11059
192.168.219.101,59977,239.255.255.250,1900,UDP,4,872,2272,4,872,0,0,9234.051448,3.009693,2317,0
192.168.219.21,42543,192.168.219.101,59977,UDP,1,558,2273,1,558,0,0,9234.057018,0,,
192.168.219.100,54375,192.168.219.101,59977,UDP,4,1512,2274,4,1512,0,0,9234.08986,0.202457,59746,0
192.168.219.101,42257,61.41.153.2,53,UDP,2,190,2275,1,87,1,103,9234.094719,0.004576,,
192.168.219.101,30698,61.41.153.2,53,UDP,2,231,2276,1,87,1,144,9234.09474,0.004554,,
192.168.219.101,56947,142.250.204.106,443,UDP,18,5987,2277,9,2771,9,3216,9234.099783,0.137373,161370,187285
192.168.219.21,43858,192.168.219.101,59977,UDP,1,558,2278,1,558,0,0,9235.057703,0,,
192.168.219.100,42923,192.168.219.101,59977,UDP,4,1512,2279,4,1512,0,0,9235.319854,0.20206,59863,0
192.168.219.101,65484,61.41.153.2,53,UDP,2,198,2280,1,79,1,119,9235.8724,0.009059,69764,105088
192.168.219.101,3626,61.41.153.2,53,UDP,2,232,2281,1,79,1,153,9235.872455,0.009004,70191,135939
192.168.219.101,65043,142.250.66.142,443,UDP,18,6232,2282,9,2748,9,3484,9235.881948,0.267281,82250,104279
192.168.219.21,47724,192.168.219.101,59977,UDP,1,558,2283,1,558,0,0,9236.063943,0,,
192.168.219.100,39823,192.168.219.101,59977,UDP,4,1512,2284,4,1512,0,0,9236.241046,0.201097,60150,0
192.168.219.21,37116,192.168.219.101,59977,UDP,1,558,2285,1,558,0,0,9237.073063,0,,
192.168.219.100,36734,192.168.219.101,59977,UDP,4,1512,2286,4,1512,0,0,9237.169184,0.197547,61230,0
192.168.219.101,52841,61.41.153.2,53,UDP,2,213,2287,1,78,1,135,9237.218463,0.024817,25144,43518
192.168.219.101,57383,61.41.153.2,53,UDP,2,412,2288,1,78,1,334,9237.218538,0.024743,25219,107990
192.168.219.101,65444,216.58.200.234,443,UDP,30,13222,2289,16,5207,14,8015,9237.253825,0.418881,99445,153074
192.168.219.101,63803,216.58.200.234,443,TCP,3,206,623,2,132,1,74,9237.417123,0.042157,25049,14042
192.168.219.101,53283,216.58.200.234,443,UDP,30,14615,2290,16,5707,14,8908,9237.649887,0.363269,125680,196174
192.168.219.101,63804,216.58.200.234,443,TCP,3,206,624,2,132,1,74,9237.784047,0.042901,24614,13799
192.168.219.101,62569,216.58.200.234,443,UDP,36,19075,2291,17,6133,19,12942,9238.01963,0.35449,138407,292070
192.168.219.101,65415,142.250.204.42,443,UDP,30,13821,2292,16,5546,14,8275,9238.398618,0.361501,122732,183125
192.168.219.101,57429,61.41.153.2,53,UDP,2,250,2293,1,77,1,173,9239.21076,0.007194,85626,192382
192.168.219.101,49436,61.41.153.2,53,UDP,2,212,2294,1,77,1,135,9239.210957,0.006998,88025,154329
192.168.219.101,56971,61.41.153.2,53,UDP,2,242,2295,1,91,1,151,9239.218747,0.004569,,
192.168.219.101,63805,15.164.151.105,443,TCP,35,12393,625,16,5553,19,6840,9239.226345,22.991404,1932,2380
192.168.219.101,62714,61.41.153.2,53,UDP,2,264,2296,1,75,1,189,9239.377465,0.004671,,
192.168.219.101,49769,61.41.153.2,53,UDP,2,278,2297,1,75,1,203,9239.377549,0.004586,,
192.168.219.101,52469,61.41.153.2,53,UDP,2,241,2298,1,78,1,163,9239.382961,0.005504,113372,236918
192.168.219.101,58618,17.248.161.70,443,UDP,25,9449,2299,14,5742,11,3707,9239.408301,20.24895,2268,1464
192.168.219.101,62859,139.178.159.27,443,UDP,54,22862,2300,25,9744,29,13118,9239.595142,20.528528,3797,5112
192.168.219.101,57660,139.178.159.21,443,UDP,14,5933,2301,7,3383,7,2550,9239.600803,20.060944,1349,1016
192.168.219.101,3722,192.168.219.103,3722,UDP,1,46,2302,1,46,0,0,9242.09788,0,,